0x10EAE998, 38049089309038912, 86997118, 86997193, 75, 1366x768 
0x10EAE998, 38049089311706520, 86997385, 86997392, 7, 1366x768 
0x10EAE998, 38049089317048152, 86997905, 86997909, 4, 1366x768 
0x10EAE998, 38049089318386952, 86998042, 86998045, 3, 1366x768 
0x10EAE998, 38049089319716288, 86998175, 86998179, 4, 1366x768 
0x10EAE998, 38049089322384288, 86998441, 86998445, 4, 1366x768 
0x10EAE998, 38049089323752376, 86998582, 86998586, 4, 1366x768 
0x10EAE998, 38049089325090440, 86998708, 86998711, 3, 1366x768 
0x10EAE998, 38049089326418480, 86998847, 86998852, 5, 1366x768 
0x10EAE998, 38049089327791016, 86998979, 86998987, 8, 1366x768 
0x10EAE998, 38049089329126792, 86999111, 86999116, 5, 1366x768 
0x10EAE998, 38049089330456056, 86999244, 86999248, 4, 1366x768 
0x10EAE998, 38049089331788416, 86999379, 86999383, 4, 1366x768 
0x10EAE998, 38049089333122088, 86999535, 86999539, 4, 1366x768 
0x10EAE998, 38049089334455080, 86999647, 86999652, 5, 1366x768 
0x10EAE998, 38049089335786304, 86999781, 86999785, 4, 1366x768 
0x10EAE998, 38049089337118496, 86999915, 86999918, 3, 1366x768 
0x10EAE998, 38049089338464200, 87000046, 87000050, 4, 1366x768 
0x10EAE998, 38049089339795840, 87000182, 87000186, 4, 1366x768 
0x10EAE998, 38049089341142328, 87000320, 87000348, 28, 1366x768 
0x10EAE998, 38049089342472552, 87000456, 87000459, 3, 1366x768 
0x10EAE998, 38049089343962240, 87000606, 87000610, 4, 1366x768 
0x10EAE998, 38049089345287776, 87000731, 87000735, 4, 1366x768 
0x10EAE998, 38049089346620008, 87000882, 87000885, 3, 1366x768 
0x10EAE998, 38049089347951240, 87000995, 87000999, 4, 1366x768 
0x10EAE998, 38049089349294712, 87001128, 87001132, 4, 1366x768 
0x10EAE998, 38049089350625328, 87001264, 87001268, 4, 1366x768 
0x10EAE998, 38049089351966208, 87001400, 87001404, 4, 1366x768 
0x10EAE998, 38049089353293080, 87001530, 87001533, 3, 1366x768 
0x10EAE998, 38049089354627800, 87001683, 87001687, 4, 1366x768 
0x10EAE998, 38049089355956672, 87001799, 87001802, 3, 1366x768 
0x10EAE998, 38049089356633328, 87001865, 87001868, 3, 1366x768 
0x10EAE998, 38049089357300128, 87001932, 87001935, 3, 1366x768 
0x10EAE998, 38049089357973344, 87001999, 87002003, 4, 1366x768 
0x10EAE998, 38049089358638952, 87002066, 87002070, 4, 1366x768 
0x10EAE998, 38049089359300752, 87002130, 87002133, 3, 1366x768 
0x10EAE998, 38049089359964664, 87002200, 87002204, 4, 1366x768 
0x10EAE998, 38049089360634520, 87002262, 87002266, 4, 1366x768 
0x10EAE998, 38049089361304640, 87002352, 87002355, 3, 1366x768 
0x10EAE998, 38049089361976160, 87002421, 87002425, 4, 1366x768 
0x10EAE998, 38049089362715992, 87002491, 87002506, 15, 1366x768 
0x10EAE998, 38049089363382600, 87002580, 87002587, 7, 1366x768 
0x10EAE998, 38049089364050688, 87002609, 87002612, 3, 1366x768 
0x10EAE998, 38049089364723792, 87002674, 87002677, 3, 1366x768 
0x10EAE998, 38049089365388264, 87002743, 87002747, 4, 1366x768 
0x10EAE998, 38049089366052352, 87002808, 87002812, 4, 1366x768 
0x10EAE998, 38049089366718192, 87002875, 87002879, 4, 1366x768 
0x10EAE998, 38049089367387488, 87002942, 87002946, 4, 1366x768 
0x10EAE998, 38049089368063696, 87003009, 87003013, 4, 1366x768 
0x10EAE998, 38049089368732144, 87003074, 87003078, 4, 1366x768 
0x10EAE998, 38049089369400608, 87003143, 87003146, 3, 1366x768 
0x10EAE998, 38049089370070544, 87003208, 87003211, 3, 1366x768 
0x10EAE998, 38049089370737584, 87003274, 87003278, 4, 1366x768 
0x10EAE998, 38049089371404936, 87003343, 87003347, 4, 1366x768 
0x10EAE998, 38049089372069144, 87003430, 87003434, 4, 1366x768 
0x10EAE998, 38049089372741808, 87003475, 87003478, 3, 1366x768 
0x10EAE998, 38049089373401176, 87003541, 87003545, 4, 1366x768 
0x10EAE998, 38049089374102656, 87003611, 87003618, 7, 1366x768 
0x10EAE998, 38049089374779600, 87003686, 87003690, 4, 1366x768 
0x10EAE998, 38049089375446968, 87003748, 87003752, 4, 1366x768 
0x10EAE998, 38049089376114496, 87003815, 87003818, 3, 1366x768 
0x10EAE998, 38049089376782584, 87003879, 87003882, 3, 1366x768 
0x10EAE998, 38049089377450912, 87003966, 87003969, 3, 1366x768 
0x10EAE998, 38049089378124136, 87004012, 87004017, 5, 1366x768 
0x10EAE998, 38049089378790768, 87004082, 87004086, 4, 1366x768 
0x10EAE998, 38049089379459040, 87004147, 87004152, 5, 1366x768 
0x10EAE998, 38049089380128176, 87004214, 87004219, 5, 1366x768 
0x10EAE998, 38049089380796208, 87004285, 87004289, 4, 1366x768 
0x10EAE998, 38049089381464384, 87004348, 87004351, 3, 1366x768 
0x10EAE998, 38049089382134208, 87004421, 87004425, 4, 1366x768 
0x10EAE998, 38049089382801008, 87004499, 87004503, 4, 1366x768 
0x10EAE998, 38049089383474600, 87004574, 87004578, 4, 1366x768 
0x10EAE998, 38049089384143272, 87004621, 87004629, 8, 1366x768 
0x10EAE998, 38049089384810312, 87004688, 87004692, 4, 1366x768 
0x10EAE998, 38049089385479096, 87004766, 87004769, 3, 1366x768 
0x10EAE998, 38049089386146952, 87004833, 87004837, 4, 1366x768 
0x10EAE998, 38049089391472688, 87005368, 87005372, 4, 1366x768 
0x10EAE998, 38049089392806984, 87005488, 87005491, 3, 1366x768 
0x10EAE998, 38049089393475168, 87005548, 87005553, 5, 1366x768 
0x10EAE998, 38049089394143272, 87005619, 87005625, 6, 1366x768 
0x10EAE998, 38049089394811608, 87005679, 87005683, 4, 1366x768 
0x10EAE998, 38049089395480824, 87005767, 87005771, 4, 1366x768 
0x10EAE998, 38049089398160760, 87006017, 87006020, 3, 1366x768 
0x10EAE998, 38049089398829496, 87006086, 87006089, 3, 1366x768 
0x10EAE998, 38049089399505200, 87006151, 87006155, 4, 1366x768 
0x10EAE998, 38049089400173752, 87006217, 87006220, 3, 1366x768 
0x10EAE998, 38049089400841600, 87006288, 87006291, 3, 1366x768 
0x10EAE998, 38049089401509768, 87006353, 87006356, 3, 1366x768 
0x10EAE998, 38049089402180880, 87006419, 87006423, 4, 1366x768 
0x10EAE998, 38049089402858224, 87006486, 87006489, 3, 1366x768 
0x10EAE998, 38049089403535760, 87006555, 87006558, 3, 1366x768 
0x10EAE998, 38049089404204032, 87006620, 87006624, 4, 1366x768 
0x10EAE998, 38049089404877960, 87006689, 87006693, 4, 1366x768 
0x10EAE998, 38049089405554688, 87006759, 87006762, 3, 1366x768 
0x10EAE998, 38049089406226632, 87006824, 87006827, 3, 1366x768 
0x10EAE998, 38049089406900952, 87006890, 87006893, 3, 1366x768 
0x10EAE998, 38049089407570960, 87006957, 87006962, 5, 1366x768 
0x10EAE998, 38049089408241320, 87007027, 87007030, 3, 1366x768 
0x10EAE998, 38049089408907224, 87007092, 87007096, 4, 1366x768 
0x10EAE998, 38049089409579920, 87007161, 87007165, 4, 1366x768 
0x10EAE998, 38049089410245784, 87007227, 87007230, 3, 1366x768 
0x10EAE998, 38049089410913952, 87007292, 87007295, 3, 1366x768 
0x10EAE998, 38049089411582400, 87007360, 87007363, 3, 1366x768 
0x10EAE998, 38049089412250600, 87007427, 87007431, 4, 1366x768 
0x10EAE998, 38049089412914520, 87007491, 87007495, 4, 1366x768 
0x10EAE998, 38049089413585536, 87007559, 87007563, 4, 1366x768 
0x10EAE998, 38049089414258504, 87007628, 87007632, 4, 1366x768 
0x10EAE998, 38049089414927792, 87007691, 87007695, 4, 1366x768 
0x10EAE998, 38049089415601752, 87007760, 87007764, 4, 1366x768 
0x10EAE998, 38049089416268664, 87007830, 87007834, 4, 1366x768 
0x10EAE998, 38049089416940528, 87007898, 87007901, 3, 1366x768 
0x10EAE998, 38049089417606552, 87007984, 87007988, 4, 1366x768 
0x10EAE998, 38049089422965464, 87008518, 87008521, 3, 1366x768 
0x10EAE998, 38049089428302208, 87009051, 87009055, 4, 1366x768 
0x10EAE998, 38049089432304152, 87009431, 87009434, 3, 1366x768 
0x10EAE998, 38049089432975632, 87009502, 87009505, 3, 1366x768 
0x10EAE998, 38049089433645376, 87009565, 87009568, 3, 1366x768 
0x10EAE998, 38049089434314488, 87009631, 87009635, 4, 1366x768 
0x10EAE998, 38049089434978288, 87009700, 87009704, 4, 1366x768 
0x10EAE998, 38049089435649336, 87009768, 87009772, 4, 1366x768 
0x10EAE998, 38049089436317512, 87009832, 87009835, 3, 1366x768 
0x10EAE998, 38049089436989288, 87009900, 87009904, 4, 1366x768 
0x10EAE998, 38049089437655848, 87009969, 87009972, 3, 1366x768 
0x10EAE998, 38049089438329144, 87010032, 87010036, 4, 1366x768 
0x10EAE998, 38049089439001280, 87010100, 87010103, 3, 1366x768 
0x10EAE998, 38049089439668096, 87010167, 87010171, 4, 1366x768 
0x10EAE998, 38049089440340384, 87010257, 87010260, 3, 1366x768 
0x10EAE998, 38049089441000544, 87010319, 87010322, 3, 1366x768 
0x10EAE998, 38049089446309272, 87010849, 87010853, 4, 1366x768 
0x10EAE998, 38049089451650296, 87011389, 87011393, 4, 1366x768 
0x10EAE998, 38049089456983824, 87011921, 87011925, 4, 1366x768 
0x10EAE998, 38049089462336992, 87012455, 87012459, 4, 1366x768 
0x10EAE998, 38049089467702616, 87012989, 87012993, 4, 1366x768 
0x10EAE998, 38049089473037544, 87013523, 87013526, 3, 1366x768 
0x10EAE998, 38049089478395432, 87014063, 87014067, 4, 1366x768 
0x10EAE998, 38049089483741144, 87014595, 87014599, 4, 1366x768 
0x10EAE998, 38049089489084440, 87015127, 87015131, 4, 1366x768 
0x10EAE998, 38049089494424112, 87015665, 87015668, 3, 1366x768 
0x10EAE998, 38049089499753848, 87016194, 87016198, 4, 1366x768 
0x10EAE998, 38049089505086784, 87016731, 87016735, 4, 1366x768 
0x10EAE998, 38049089510405800, 87017262, 87017265, 3, 1366x768 
0x10EAE998, 38049089515757760, 87017795, 87017798, 3, 1366x768 
0x10EAE998, 38049089521090552, 87018332, 87018336, 4, 1366x768 
0x10EAE998, 38049089526427032, 87018863, 87018866, 3, 1366x768 
0x10EAE998, 38049089531749880, 87019393, 87019397, 4, 1366x768 
0x10EAE998, 38049089537100032, 87019931, 87019935, 4, 1366x768 
0x10EAE998, 38049089542433944, 87020466, 87020469, 3, 1366x768 
0x10EAE998, 38049089547761048, 87020994, 87020998, 4, 1366x768 
0x10EAE998, 38049089553116000, 87021531, 87021534, 3, 1366x768 
0x10EAE998, 38049089558462208, 87022066, 87022070, 4, 1366x768 
0x10EAE998, 38049089563817904, 87022600, 87022603, 3, 1366x768 
0x10EAE998, 38049089569128840, 87023133, 87023137, 4, 1366x768 
0x10EAE998, 38049089574458400, 87023668, 87023672, 4, 1366x768 
0x10EAE998, 38049089579784752, 87024200, 87024204, 4, 1366x768 
0x10EAE998, 38049089585140896, 87024733, 87024737, 4, 1366x768 
0x10EAE998, 38049089590476256, 87025268, 87025272, 4, 1366x768 
0x10EAE998, 38049089595810952, 87025800, 87025803, 3, 1366x768 
0x10EAE998, 38049089601156472, 87026334, 87026337, 3, 1366x768 
0x10EAE998, 38049089606511800, 87026871, 87026874, 3, 1366x768 
0x10EAE998, 38049089610513512, 87027252, 87027256, 4, 1366x768 
0x10EAE998, 38049089611177712, 87027322, 87027326, 4, 1366x768 
0x10EAE998, 38049089611850336, 87027386, 87027390, 4, 1366x768 
0x10EAE998, 38049089612524808, 87027456, 87027459, 3, 1366x768 
0x10EAE998, 38049089613192952, 87027521, 87027524, 3, 1366x768 
0x10EAE998, 38049089613865256, 87027588, 87027592, 4, 1366x768 
0x10EAE998, 38049089614536440, 87027655, 87027658, 3, 1366x768 
0x10EAE998, 38049089615207328, 87027724, 87027728, 4, 1366x768 
0x10EAE998, 38049089615881904, 87027791, 87027794, 3, 1366x768 
0x10EAE998, 38049089616548616, 87027857, 87027861, 4, 1366x768 
0x10EAE998, 38049089617208344, 87027925, 87027928, 3, 1366x768 
0x10EAE998, 38049089617871976, 87027992, 87027996, 4, 1366x768 
0x10EAE998, 38049089618539216, 87028055, 87028058, 3, 1366x768 
0x10EAE998, 38049089619206200, 87028122, 87028125, 3, 1366x768 
0x10EAE998, 38049089619873864, 87028189, 87028193, 4, 1366x768 
0x10EAE998, 38049089620536120, 87028258, 87028261, 3, 1366x768 
0x10EAE998, 38049089621195168, 87028320, 87028323, 3, 1366x768 
0x10EAE998, 38049089621855912, 87028387, 87028391, 4, 1366x768 
0x10EAE998, 38049089622524752, 87028454, 87028458, 4, 1366x768 
0x10EAE998, 38049089623194816, 87028522, 87028525, 3, 1366x768 
0x10EAE998, 38049089623866000, 87028585, 87028589, 4, 1366x768 
0x10EAE998, 38049089624541392, 87028654, 87028658, 4, 1366x768 
0x10EAE998, 38049089625215264, 87028724, 87028728, 4, 1366x768 
0x10EAE998, 38049089625885488, 87028791, 87028795, 4, 1366x768 
0x10EAE998, 38049089631239088, 87029342, 87029345, 3, 1366x768 
0x10EAE998, 38049089636582024, 87029876, 87029880, 4, 1366x768 
0x10EAE998, 38049089641919360, 87030410, 87030414, 4, 1366x768 
0x10EAE998, 38049089647361496, 87030956, 87030959, 3, 1366x768 
0x10EAE998, 38049089652690328, 87031488, 87031492, 4, 1366x768 
0x10EAE998, 38049089658029232, 87032021, 87032025, 4, 1366x768 
0x10EAE998, 38049089663366440, 87032559, 87032563, 4, 1366x768 
0x10EAE998, 38049089668703944, 87033089, 87033093, 4, 1366x768 
0x10EAE998, 38049089674057552, 87033628, 87033632, 4, 1366x768 
0x10EAE998, 38049089677402032, 87033947, 87033950, 3, 1366x768 
0x10EAE998, 38049089678071408, 87034008, 87034011, 3, 1366x768 
0x10EAE998, 38049089678739592, 87034073, 87034076, 3, 1366x768 
0x10EAE998, 38049089679409032, 87034142, 87034145, 3, 1366x768 
0x10EAE998, 38049089680081424, 87034208, 87034212, 4, 1366x768 
0x10EAE998, 38049089680754160, 87034274, 87034278, 4, 1366x768 
0x10EAE998, 38049089681419104, 87034346, 87034350, 4, 1366x768 
0x10EAE998, 38049089682090848, 87034412, 87034415, 3, 1366x768 
0x10EAE998, 38049089682762520, 87034479, 87034483, 4, 1366x768 
0x10EAE998, 38049089683436280, 87034547, 87034550, 3, 1366x768 
0x10EAE998, 38049089684111152, 87034614, 87034617, 3, 1366x768 
0x10EAE998, 38049089684782864, 87034681, 87034685, 4, 1366x768 
0x10EAE998, 38049089685453424, 87034750, 87034753, 3, 1366x768 
0x10EAE998, 38049089686113576, 87034812, 87034815, 3, 1366x768 
0x10EAE998, 38049089686781728, 87034878, 87034881, 3, 1366x768 
0x10EAE998, 38049089687454728, 87034949, 87034953, 4, 1366x768 
0x10EAE998, 38049089688125432, 87035016, 87035020, 4, 1366x768 
0x10EAE998, 38049089688794344, 87035084, 87035088, 4, 1366x768 
0x10EAE998, 38049089689463920, 87035147, 87035151, 4, 1366x768 
0x10EAE998, 38049089690133328, 87035217, 87035221, 4, 1366x768 
0x10EAE998, 38049089690804952, 87035281, 87035285, 4, 1366x768 
0x10EAE998, 38049089691475208, 87035351, 87035354, 3, 1366x768 
0x10EAE998, 38049089692140680, 87035416, 87035419, 3, 1366x768 
0x10EAE998, 38049089692809016, 87035482, 87035485, 3, 1366x768 
0x10EAE998, 38049089693477080, 87035548, 87035551, 3, 1366x768 
0x10EAE998, 38049089694147256, 87035618, 87035622, 4, 1366x768 
0x10EAE998, 38049089694819648, 87035685, 87035689, 4, 1366x768 
0x10EAE998, 38049089695490392, 87035752, 87035756, 4, 1366x768 
0x10EAE998, 38049089700848112, 87036306, 87036309, 3, 1366x768 
0x10EAE998, 38049089706199088, 87036839, 87036843, 4, 1366x768 
0x10EAE998, 38049089711532096, 87037375, 87037379, 4, 1366x768 
0x10EAE998, 38049089712875208, 87037489, 87037493, 4, 1366x768 
0x10EAE998, 38049089713543152, 87037553, 87037557, 4, 1366x768 
0x10EAE998, 38049089714211704, 87037625, 87037629, 4, 1366x768 
0x10EAE998, 38049089714878872, 87037689, 87037693, 4, 1366x768 
0x10EAE998, 38049089715553920, 87037755, 87037758, 3, 1366x768 
0x10EAE998, 38049089716222656, 87037826, 87037830, 4, 1366x768 
0x10EAE998, 38049089716892480, 87037891, 87037895, 4, 1366x768 
0x10EAE998, 38049089717568888, 87037959, 87037962, 3, 1366x768 
0x10EAE998, 38049089718239056, 87038026, 87038030, 4, 1366x768 
0x10EAE998, 38049089718910128, 87038093, 87038097, 4, 1366x768 
0x10EAE998, 38049089719584376, 87038159, 87038163, 4, 1366x768 
0x10EAE998, 38049089720259000, 87038229, 87038232, 3, 1366x768 
0x10EAE998, 38049089720933344, 87038295, 87038298, 3, 1366x768 
0x10EAE998, 38049089721605904, 87038362, 87038365, 3, 1366x768 
0x10EAE998, 38049089722276344, 87038430, 87038434, 4, 1366x768 
0x10EAE998, 38049089722935808, 87038494, 87038498, 4, 1366x768 
0x10EAE998, 38049089723607696, 87038561, 87038564, 3, 1366x768 
0x10EAE998, 38049089724279472, 87038628, 87038631, 3, 1366x768 
0x10EAE998, 38049089724953952, 87038698, 87038702, 4, 1366x768 
0x10EAE998, 38049089725621144, 87038766, 87038770, 4, 1366x768 
0x10EAE998, 38049089726294232, 87038829, 87038834, 5, 1366x768 
0x10EAE998, 38049089726954656, 87038898, 87038901, 3, 1366x768 
0x10EAE998, 38049089727622512, 87038962, 87038966, 4, 1366x768 
0x10EAE998, 38049089728291048, 87039033, 87039037, 4, 1366x768 
0x10EAE998, 38049089728962152, 87039096, 87039100, 4, 1366x768 
0x10EAE998, 38049089729632856, 87039166, 87039170, 4, 1366x768 
0x10EAE998, 38049089730303616, 87039233, 87039237, 4, 1366x768 
0x10EAE998, 38049089730975576, 87039298, 87039301, 3, 1366x768 
0x10EAE998, 38049089731647464, 87039368, 87039372, 4, 1366x768 
0x10EAE998, 38049089732310960, 87039431, 87039435, 4, 1366x768 
0x10EAE998, 38049089732979720, 87039498, 87039501, 3, 1366x768 
0x10EAE998, 38049089733645656, 87039567, 87039571, 4, 1366x768 
0x10EAE998, 38049089734319536, 87039634, 87039638, 4, 1366x768 
0x10EAE998, 38049089734991256, 87039701, 87039704, 3, 1366x768 
0x10EAE998, 38049089735659496, 87039769, 87039773, 4, 1366x768 
0x10EAE998, 38049089736332584, 87039835, 87039839, 4, 1366x768 
0x10EAE998, 38049089737003752, 87039901, 87039905, 4, 1366x768 
0x10EAE998, 38049089737677960, 87039968, 87039972, 4, 1366x768 
0x10EAE998, 38049089738342184, 87040039, 87040042, 3, 1366x768 
0x10EAE998, 38049089739013664, 87040101, 87040104, 3, 1366x768 
0x10EAE998, 38049089739682024, 87040167, 87040171, 4, 1366x768 
0x10EAE998, 38049089740353352, 87040238, 87040242, 4, 1366x768 
0x10EAE998, 38049089741025248, 87040307, 87040311, 4, 1366x768 
0x10EAE998, 38049089741699656, 87040371, 87040374, 3, 1366x768 
0x10EAE998, 38049089742372152, 87040440, 87040444, 4, 1366x768 
0x10EAE998, 38049089743040168, 87040504, 87040508, 4, 1366x768 
0x10EAE998, 38049089743704976, 87040570, 87040574, 4, 1366x768 
0x10EAE998, 38049089744381536, 87040637, 87040641, 4, 1366x768 
0x10EAE998, 38049089745054048, 87040703, 87040707, 4, 1366x768 
0x10EAE998, 38049089745726664, 87040775, 87040779, 4, 1366x768 
0x10EAE998, 38049089746396632, 87040840, 87040844, 4, 1366x768 
0x10EAE998, 38049089747067808, 87040906, 87040909, 3, 1366x768 
0x10EAE998, 38049089747734848, 87040975, 87040979, 4, 1366x768 
0x10EAE998, 38049089748407720, 87041043, 87041047, 4, 1366x768 
0x10EAE998, 38049089749074216, 87041109, 87041113, 4, 1366x768 
0x10EAE998, 38049089749743352, 87041175, 87041179, 4, 1366x768 
0x10EAE998, 38049089750413368, 87041243, 87041246, 3, 1366x768 
0x10EAE998, 38049089751089528, 87041311, 87041315, 4, 1366x768 
0x10EAE998, 38049089751760496, 87041378, 87041381, 3, 1366x768 
0x10EAE998, 38049089752429016, 87041444, 87041448, 4, 1366x768 
0x10EAE998, 38049089753097296, 87041511, 87041515, 4, 1366x768 
0x10EAE998, 38049089753771400, 87041577, 87041581, 4, 1366x768 
0x10EAE998, 38049089754447464, 87041645, 87041649, 4, 1366x768 
0x10EAE998, 38049089755121040, 87041712, 87041716, 4, 1366x768 
0x10EAE998, 38049089755789208, 87041782, 87041785, 3, 1366x768 
0x10EAE998, 38049089756463760, 87041846, 87041850, 4, 1366x768 
0x10EAE998, 38049089757133280, 87041914, 87041917, 3, 1366x768 
0x10EAE998, 38049089757801216, 87041981, 87041985, 4, 1366x768 
0x10EAE998, 38049089758468384, 87042048, 87042052, 4, 1366x768 
0x10EAE998, 38049089759139040, 87042115, 87042120, 5, 1366x768 
0x10EAE998, 38049089759812152, 87042185, 87042188, 3, 1366x768 
0x10EAE998, 38049089760480376, 87042251, 87042255, 4, 1366x768 
0x10EAE998, 38049089761158056, 87042317, 87042320, 3, 1366x768 
0x10EAE998, 38049089761822664, 87042385, 87042389, 4, 1366x768 
0x10EAE998, 38049089762493848, 87042449, 87042453, 4, 1366x768 
0x10EAE998, 38049089763167784, 87042520, 87042524, 4, 1366x768 
0x10EAE998, 38049089763832240, 87042582, 87042586, 4, 1366x768 
0x10EAE998, 38049089764504832, 87042651, 87042654, 3, 1366x768 
0x10EAE998, 38049089765178224, 87042718, 87042721, 3, 1366x768 
0x10EAE998, 38049089765844464, 87042785, 87042789, 4, 1366x768 
0x10EAE998, 38049089766510296, 87042854, 87042858, 4, 1366x768 
0x10EAE998, 38049089767185016, 87042917, 87042921, 4, 1366x768 
0x10EAE998, 38049089767850544, 87042985, 87042989, 4, 1366x768 
0x10EAE998, 38049089768515488, 87043052, 87043055, 3, 1366x768 
0x10EAE998, 38049089769185272, 87043118, 87043121, 3, 1366x768 
0x10EAE998, 38049089769852432, 87043185, 87043188, 3, 1366x768 
0x10EAE998, 38049089770524688, 87043255, 87043258, 3, 1366x768 
0x10EAE998, 38049089771183256, 87043318, 87043321, 3, 1366x768 
0x10EAE998, 38049089771851288, 87043389, 87043392, 3, 1366x768 
0x10EAE998, 38049089772519728, 87043455, 87043458, 3, 1366x768 
0x10EAE998, 38049089773187352, 87043518, 87043522, 4, 1366x768 
0x10EAE998, 38049089773854664, 87043587, 87043591, 4, 1366x768 
0x10EAE998, 38049089774533384, 87043654, 87043657, 3, 1366x768 
0x10EAE998, 38049089775206536, 87043724, 87043727, 3, 1366x768 
0x10EAE998, 38049089775881472, 87043791, 87043795, 4, 1366x768 
0x10EAE998, 38049089776552256, 87043857, 87043860, 3, 1366x768 
0x10EAE998, 38049089777218848, 87043924, 87043928, 4, 1366x768 
0x10EAE998, 38049089777888416, 87043990, 87043994, 4, 1366x768 
0x10EAE998, 38049089778555608, 87044057, 87044060, 3, 1366x768 
0x10EAE998, 38049089779224792, 87044126, 87044130, 4, 1366x768 
0x10EAE998, 38049089779899672, 87044194, 87044198, 4, 1366x768 
0x10EAE998, 38049089780576096, 87044279, 87044282, 3, 1366x768 
0x10EAE998, 38049089781237480, 87044340, 87044344, 4, 1366x768 
0x10EAE998, 38049089781902256, 87044393, 87044397, 4, 1366x768 
0x10EAE998, 38049089782577512, 87044460, 87044464, 4, 1366x768 
0x10EAE998, 38049089783253512, 87044526, 87044530, 4, 1366x768 
0x10EAE998, 38049089783922752, 87044595, 87044598, 3, 1366x768 
0x10EAE998, 38049089784596840, 87044663, 87044667, 4, 1366x768 
0x10EAE998, 38049089785264168, 87044726, 87044730, 4, 1366x768 
0x10EAE998, 38049089785932568, 87044797, 87044801, 4, 1366x768 
0x10EAE998, 38049089786600480, 87044860, 87044864, 4, 1366x768 
0x10EAE998, 38049089787274592, 87044928, 87044932, 4, 1366x768 
0x10EAE998, 38049089787943968, 87044995, 87044999, 4, 1366x768 
0x10EAE998, 38049089788613832, 87045063, 87045066, 3, 1366x768 
0x10EAE998, 38049089789288232, 87045152, 87045155, 3, 1366x768 
0x10EAE998, 38049089793959576, 87045618, 87045621, 3, 1366x768 
0x10EAE998, 38049089794625792, 87045665, 87045668, 3, 1366x768 
0x10EAE998, 38049089795297056, 87045730, 87045734, 4, 1366x768 
0x10EAE998, 38049089795970584, 87045796, 87045799, 3, 1366x768 
0x10EAE998, 38049089796641432, 87045863, 87045867, 4, 1366x768 
0x10EAE998, 38049089797309072, 87045933, 87045937, 4, 1366x768 
0x10EAE998, 38049089797978160, 87046000, 87046003, 3, 1366x768 
0x10EAE998, 38049089798639520, 87046066, 87046070, 4, 1366x768 
0x10EAE998, 38049089799313048, 87046132, 87046136, 4, 1366x768 
0x10EAE998, 38049089799979344, 87046201, 87046204, 3, 1366x768 
0x10EAE998, 38049089800647184, 87046287, 87046290, 3, 1366x768 
0x10EAE998, 38049089801318008, 87046353, 87046357, 4, 1366x768 
0x10EAE998, 38049089806670256, 87046889, 87046893, 4, 1366x768 
0x10EAE998, 38049089808002416, 87047006, 87047010, 4, 1366x768 
0x10EAE998, 38049089808662512, 87047068, 87047072, 4, 1366x768 
0x10EAE998, 38049089809335848, 87047137, 87047140, 3, 1366x768 
0x10EAE998, 38049089810002608, 87047205, 87047209, 4, 1366x768 
0x10EAE998, 38049089810674296, 87047288, 87047292, 4, 1366x768 
0x10EAE998, 38049089811340264, 87047334, 87047338, 4, 1366x768 
0x10EAE998, 38049089812010960, 87047403, 87047406, 3, 1366x768 
0x10EAE998, 38049089812682368, 87047470, 87047474, 4, 1366x768 
0x10EAE998, 38049089813349128, 87047537, 87047541, 4, 1366x768 
0x10EAE998, 38049089814026120, 87047605, 87047609, 4, 1366x768 
0x10EAE998, 38049089814695952, 87047674, 87047678, 4, 1366x768 
0x10EAE998, 38049089815363136, 87047739, 87047743, 4, 1366x768 
0x10EAE998, 38049089816035632, 87047822, 87047827, 5, 1366x768 
0x10EAE998, 38049089817377848, 87047940, 87047943, 3, 1366x768 
0x10EAE998, 38049089818053688, 87048007, 87048010, 3, 1366x768 
0x10EAE998, 38049089818722456, 87048075, 87048079, 4, 1366x768 
0x10EAE998, 38049089819396384, 87048142, 87048146, 4, 1366x768 
0x10EAE998, 38049089820066288, 87048205, 87048209, 4, 1366x768 
0x10EAE998, 38049089820733328, 87048277, 87048280, 3, 1366x768 
0x10EAE998, 38049089821401536, 87048341, 87048345, 4, 1366x768 
0x10EAE998, 38049089822076408, 87048408, 87048412, 4, 1366x768 
0x10EAE998, 38049089822744352, 87048473, 87048477, 4, 1366x768 
0x10EAE998, 38049089823416464, 87048561, 87048564, 3, 1366x768 
0x10EAE998, 38049089828097488, 87049011, 87049015, 4, 1366x768 
0x10EAE998, 38049089828764600, 87049076, 87049080, 4, 1366x768 
0x10EAE998, 38049089829432704, 87049163, 87049166, 3, 1366x768 
0x10EAE998, 38049089830101296, 87049229, 87049233, 4, 1366x768 
0x10EAE998, 38049089832767072, 87049476, 87049480, 4, 1366x768 
0x10EAE998, 38049089833433288, 87049544, 87049547, 3, 1366x768 
0x10EAE998, 38049089834091352, 87049611, 87049615, 4, 1366x768 
0x10EAE998, 38049089834761944, 87049680, 87049683, 3, 1366x768 
0x10EAE998, 38049089835428560, 87049745, 87049748, 3, 1366x768 
0x10EAE998, 38049089836103208, 87049812, 87049816, 4, 1366x768 
0x10EAE998, 38049089836774368, 87049879, 87049883, 4, 1366x768 
0x10EAE998, 38049089837443016, 87049947, 87049950, 3, 1366x768 
0x10EAE998, 38049089838113912, 87050011, 87050014, 3, 1366x768 
0x10EAE998, 38049089838778384, 87050081, 87050085, 4, 1366x768 
0x10EAE998, 38049089839445392, 87050146, 87050150, 4, 1366x768 
0x10EAE998, 38049089840114064, 87050212, 87050217, 5, 1366x768 
0x10EAE998, 38049089840781840, 87050280, 87050284, 4, 1366x768 
0x10EAE998, 38049089841453440, 87050349, 87050352, 3, 1366x768 
0x10EAE998, 38049089842125600, 87050412, 87050415, 3, 1366x768 
0x10EAE998, 38049089842790800, 87050479, 87050483, 4, 1366x768 
0x10EAE998, 38049089843458512, 87050551, 87050555, 4, 1366x768 
0x10EAE998, 38049089844127592, 87050615, 87050619, 4, 1366x768 
0x10EAE998, 38049089844795792, 87050685, 87050688, 3, 1366x768 
0x10EAE998, 38049089845464448, 87050747, 87050750, 3, 1366x768 
0x10EAE998, 38049089846133440, 87050817, 87050821, 4, 1366x768 
0x10EAE998, 38049089846804624, 87050883, 87050886, 3, 1366x768 
0x10EAE998, 38049089847464120, 87050950, 87050954, 4, 1366x768 
0x10EAE998, 38049089848136168, 87051012, 87051016, 4, 1366x768 
0x10EAE998, 38049089848806368, 87051080, 87051083, 3, 1366x768 
0x10EAE998, 38049089849474216, 87051147, 87051150, 3, 1366x768 
0x10EAE998, 38049089850142696, 87051215, 87051219, 4, 1366x768 
0x10EAE998, 38049089850812192, 87051281, 87051284, 3, 1366x768 
0x10EAE998, 38049089851486352, 87051348, 87051352, 4, 1366x768 
0x10EAE998, 38049089852161200, 87051419, 87051423, 4, 1366x768 
0x10EAE998, 38049089852826568, 87051485, 87051489, 4, 1366x768 
0x10EAE998, 38049089853499904, 87051548, 87051551, 3, 1366x768 
0x10EAE998, 38049089854166472, 87051619, 87051623, 4, 1366x768 
0x10EAE998, 38049089854832360, 87051686, 87051690, 4, 1366x768 
0x10EAE998, 38049089855492648, 87051749, 87051752, 3, 1366x768 
0x10EAE998, 38049089856164808, 87051816, 87051820, 4, 1366x768 
0x10EAE998, 38049089856837816, 87051889, 87051893, 4, 1366x768 
0x10EAE998, 38049089857504648, 87051969, 87051973, 4, 1366x768 
0x10EAE998, 38049089862825920, 87052505, 87052509, 4, 1366x768 
0x10EAE998, 38049089868157896, 87053036, 87053040, 4, 1366x768 
0x10EAE998, 38049089871500936, 87053352, 87053355, 3, 1366x768 
0x10EAE998, 38049089872159584, 87053416, 87053419, 3, 1366x768 
0x10EAE998, 38049089872828200, 87053486, 87053489, 3, 1366x768 
0x10EAE998, 38049089873495488, 87053549, 87053553, 4, 1366x768 
0x10EAE998, 38049089874167760, 87053619, 87053622, 3, 1366x768 
0x10EAE998, 38049089874837136, 87053686, 87053690, 4, 1366x768 
0x10EAE998, 38049089875500288, 87053754, 87053758, 4, 1366x768 
0x10EAE998, 38049089876168048, 87053818, 87053821, 3, 1366x768 
0x10EAE998, 38049089876835104, 87053887, 87053891, 4, 1366x768 
0x10EAE998, 38049089877503080, 87053953, 87053957, 4, 1366x768 
0x10EAE998, 38049089878171512, 87054019, 87054023, 4, 1366x768 
0x10EAE998, 38049089878839616, 87054089, 87054096, 7, 1366x768 
0x10EAE998, 38049089879513696, 87054153, 87054159, 6, 1366x768 
0x10EAE998, 38049089880182112, 87054218, 87054222, 4, 1366x768 
0x10EAE998, 38049089880854768, 87054287, 87054294, 7, 1366x768 
0x10EAE998, 38049089881525952, 87054354, 87054357, 3, 1366x768 
0x10EAE998, 38049089882191904, 87054420, 87054428, 8, 1366x768 
0x10EAE998, 38049089882857440, 87054487, 87054491, 4, 1366x768 
0x10EAE998, 38049089883530488, 87054552, 87054559, 7, 1366x768 
0x10EAE998, 38049089884191800, 87054622, 87054626, 4, 1366x768 
0x10EAE998, 38049089884866496, 87054707, 87054710, 3, 1366x768 
0x10EAE998, 38049089885531032, 87054773, 87054776, 3, 1366x768 
0x10EAE998, 38049089886202416, 87054843, 87054846, 3, 1366x768 
0x10EAE998, 38049089886867040, 87054892, 87054895, 3, 1366x768 
0x10EAE998, 38049089887532856, 87054955, 87054958, 3, 1366x768 
0x10EAE998, 38049089888201128, 87055020, 87055024, 4, 1366x768 
0x10EAE998, 38049089888864208, 87055106, 87055110, 4, 1366x768 
0x10EAE998, 38049089889529000, 87055176, 87055180, 4, 1366x768 
0x10EAE998, 38049089894872176, 87055707, 87055711, 4, 1366x768 
0x10EAE998, 38049089900221816, 87056246, 87056249, 3, 1366x768 
0x10EAE998, 38049089905561720, 87056780, 87056784, 4, 1366x768 
0x10EAE998, 38049089910916032, 87057311, 87057315, 4, 1366x768 
0x10EAE998, 38049089916227000, 87057841, 87057844, 3, 1366x768 
0x10EAE998, 38049089921558784, 87058375, 87058378, 3, 1366x768 
0x10EAE998, 38049089926916200, 87058911, 87058914, 3, 1366x768 
0x10EAE998, 38049089932275936, 87059450, 87059454, 4, 1366x768 
0x10EAE998, 38049089937620048, 87059982, 87059986, 4, 1366x768 
0x10EAE998, 38049089942958800, 87060519, 87060523, 4, 1366x768 
0x10EAE998, 38049089948297544, 87061053, 87061057, 4, 1366x768 
0x10EAE998, 38049089953627800, 87061583, 87061587, 4, 1366x768 
0x10EAE998, 38049089958978440, 87062118, 87062122, 4, 1366x768 
0x10EAE998, 38049089964324872, 87062654, 87062658, 4, 1366x768 
0x10EAE998, 38049089969671744, 87063188, 87063192, 4, 1366x768 
0x10EAE998, 38049089975022080, 87063724, 87063728, 4, 1366x768 
0x10EAE998, 38049089980357232, 87064255, 87064259, 4, 1366x768 
0x10EAE998, 38049089985702456, 87064789, 87064792, 3, 1366x768 
0x10EAE998, 38049089991033232, 87065325, 87065329, 4, 1366x768 
0x10EAE998, 38049089996361656, 87065855, 87065859, 4, 1366x768 
0x10EAE998, 38049090001691728, 87066389, 87066393, 4, 1366x768 
0x10EAE998, 38049090007030224, 87066922, 87066927, 5, 1366x768 
0x10EAE998, 38049090007702704, 87066972, 87066976, 4, 1366x768 
0x10EAE998, 38049090013030648, 87067526, 87067530, 4, 1366x768 
0x10EAE998, 38049090018366192, 87068056, 87068060, 4, 1366x768 
0x10EAE998, 38049090023704160, 87068592, 87068595, 3, 1366x768 
0x10EAE998, 38049090029027840, 87069122, 87069126, 4, 1366x768 
0x10EAE998, 38049090031704352, 87069371, 87069375, 4, 1366x768 
0x10EAE998, 38049090032373536, 87069439, 87069442, 3, 1366x768 
0x10EAE998, 38049090033033816, 87069503, 87069507, 4, 1366x768 
0x10EAE998, 38049090033699472, 87069571, 87069575, 4, 1366x768 
0x10EAE998, 38049090034372968, 87069638, 87069642, 4, 1366x768 
0x10EAE998, 38049090035043440, 87069708, 87069712, 4, 1366x768 
0x10EAE998, 38049090035714880, 87069777, 87069782, 5, 1366x768 
0x10EAE998, 38049090036383112, 87069836, 87069839, 3, 1366x768 
0x10EAE998, 38049090037048600, 87069909, 87069913, 4, 1366x768 
0x10EAE998, 38049090037716824, 87069975, 87069978, 3, 1366x768 
0x10EAE998, 38049090038385712, 87070038, 87070042, 4, 1366x768 
0x10EAE998, 38049090039050384, 87070106, 87070110, 4, 1366x768 
0x10EAE998, 38049090039711312, 87070172, 87070175, 3, 1366x768 
0x10EAE998, 38049090040371096, 87070238, 87070242, 4, 1366x768 
0x10EAE998, 38049090041043104, 87070305, 87070309, 4, 1366x768 
0x10EAE998, 38049090041713544, 87070369, 87070373, 4, 1366x768 
0x10EAE998, 38049090042386768, 87070438, 87070442, 4, 1366x768 
0x10EAE998, 38049090043053616, 87070506, 87070510, 4, 1366x768 
0x10EAE998, 38049090043725576, 87070594, 87070598, 4, 1366x768 
0x10EAE998, 38049090046389504, 87070861, 87070865, 4, 1366x768 
0x10EAE998, 38049090047053456, 87070908, 87070911, 3, 1366x768 
0x10EAE998, 38049090047724680, 87070975, 87070978, 3, 1366x768 
0x10EAE998, 38049090048391984, 87071037, 87071041, 4, 1366x768 
0x10EAE998, 38049090049067704, 87071111, 87071114, 3, 1366x768 
0x10EAE998, 38049090049743328, 87071176, 87071180, 4, 1366x768 
0x10EAE998, 38049090050410992, 87071242, 87071245, 3, 1366x768 
0x10EAE998, 38049090051084592, 87071312, 87071316, 4, 1366x768 
0x10EAE998, 38049090051753232, 87071379, 87071382, 3, 1366x768 
0x10EAE998, 38049090052417448, 87071445, 87071448, 3, 1366x768 
0x10EAE998, 38049090053080776, 87071510, 87071514, 4, 1366x768 
0x10EAE998, 38049090053753096, 87071576, 87071580, 4, 1366x768 
0x10EAE998, 38049090054420312, 87071643, 87071647, 4, 1366x768 
0x10EAE998, 38049090055092672, 87071709, 87071712, 3, 1366x768 
0x10EAE998, 38049090055764880, 87071775, 87071780, 5, 1366x768 
0x10EAE998, 38049090056435488, 87071847, 87071851, 4, 1366x768 
0x10EAE998, 38049090057102168, 87071909, 87071913, 4, 1366x768 
0x10EAE998, 38049090057775264, 87071979, 87071983, 4, 1366x768 
0x10EAE998, 38049090058440112, 87072045, 87072048, 3, 1366x768 
0x10EAE998, 38049090059104664, 87072115, 87072118, 3, 1366x768 
0x10EAE998, 38049090059778936, 87072179, 87072183, 4, 1366x768 
0x10EAE998, 38049090060446032, 87072247, 87072251, 4, 1366x768 
0x10EAE998, 38049090061113048, 87072314, 87072318, 4, 1366x768 
0x10EAE998, 38049090061791816, 87072382, 87072386, 4, 1366x768 
0x10EAE998, 38049090062459992, 87072450, 87072454, 4, 1366x768 
0x10EAE998, 38049090063127584, 87072512, 87072515, 3, 1366x768 
0x10EAE998, 38049090063801480, 87072580, 87072584, 4, 1366x768 
0x10EAE998, 38049090064473800, 87072649, 87072652, 3, 1366x768 
0x10EAE998, 38049090065141952, 87072713, 87072716, 3, 1366x768 
0x10EAE998, 38049090065809984, 87072782, 87072785, 3, 1366x768 
0x10EAE998, 38049090066480984, 87072849, 87072852, 3, 1366x768 
0x10EAE998, 38049090067145888, 87072933, 87072937, 4, 1366x768 
0x10EAE998, 38049090069820960, 87073186, 87073190, 4, 1366x768 
0x10EAE998, 38049090070488000, 87073252, 87073256, 4, 1366x768 
0x10EAE998, 38049090071153688, 87073314, 87073318, 4, 1366x768 
0x10EAE998, 38049090071828464, 87073383, 87073386, 3, 1366x768 
0x10EAE998, 38049090072501040, 87073450, 87073453, 3, 1366x768 
0x10EAE998, 38049090073169696, 87073517, 87073521, 4, 1366x768 
0x10EAE998, 38049090073840160, 87073588, 87073592, 4, 1366x768 
0x10EAE998, 38049090074512704, 87073651, 87073655, 4, 1366x768 
0x10EAE998, 38049090075177472, 87073720, 87073724, 4, 1366x768 
0x10EAE998, 38049090075848408, 87073786, 87073790, 4, 1366x768 
0x10EAE998, 38049090076513464, 87073851, 87073854, 3, 1366x768 
0x10EAE998, 38049090077178400, 87073917, 87073921, 4, 1366x768 
0x10EAE998, 38049090077845808, 87073985, 87073989, 4, 1366x768 
0x10EAE998, 38049090078514952, 87074051, 87074055, 4, 1366x768 
0x10EAE998, 38049090079184640, 87074121, 87074125, 4, 1366x768 
0x10EAE998, 38049090079852696, 87074186, 87074189, 3, 1366x768 
0x10EAE998, 38049090080522904, 87074255, 87074258, 3, 1366x768 
0x10EAE998, 38049090081192400, 87074319, 87074322, 3, 1366x768 
0x10EAE998, 38049090081864608, 87074386, 87074390, 4, 1366x768 
0x10EAE998, 38049090082531240, 87074452, 87074456, 4, 1366x768 
0x10EAE998, 38049090083201208, 87074520, 87074523, 3, 1366x768 
0x10EAE998, 38049090083874120, 87074587, 87074591, 4, 1366x768 
0x10EAE998, 38049090084538848, 87074653, 87074657, 4, 1366x768 
0x10EAE998, 38049090085212008, 87074726, 87074730, 4, 1366x768 
0x10EAE998, 38049090085882904, 87074788, 87074792, 4, 1366x768 
0x10EAE998, 38049090086554320, 87074875, 87074878, 3, 1366x768 
0x10EAE998, 38049090091907312, 87075390, 87075394, 4, 1366x768 
0x10EAE998, 38049090092575176, 87075465, 87075469, 4, 1366x768 
0x10EAE998, 38049090093247016, 87075527, 87075531, 4, 1366x768 
0x10EAE998, 38049090093922248, 87075595, 87075598, 3, 1366x768 
0x10EAE998, 38049090094596168, 87075664, 87075669, 5, 1366x768 
0x10EAE998, 38049090095265048, 87075730, 87075734, 4, 1366x768 
0x10EAE998, 38049090095931952, 87075796, 87075799, 3, 1366x768 
0x10EAE998, 38049090096601224, 87075880, 87075884, 4, 1366x768 
0x10EAE998, 38049090100614600, 87076270, 87076274, 4, 1366x768 
0x10EAE998, 38049090101281056, 87076328, 87076332, 4, 1366x768 
0x10EAE998, 38049090101950000, 87076396, 87076399, 3, 1366x768 
0x10EAE998, 38049090102618864, 87076460, 87076463, 3, 1366x768 
0x10EAE998, 38049090103286488, 87076530, 87076534, 4, 1366x768 
0x10EAE998, 38049090103954776, 87076598, 87076602, 4, 1366x768 
0x10EAE998, 38049090104624216, 87076662, 87076666, 4, 1366x768 
0x10EAE998, 38049090105296904, 87076729, 87076733, 4, 1366x768 
0x10EAE998, 38049090105962976, 87076796, 87076800, 4, 1366x768 
0x10EAE998, 38049090106627040, 87076886, 87076889, 3, 1366x768 
0x10EAE998, 38049090111946888, 87077411, 87077415, 4, 1366x768 
0x10EAE998, 38049090112611760, 87077462, 87077465, 3, 1366x768 
0x10EAE998, 38049090113281016, 87077531, 87077535, 4, 1366x768 
0x10EAE998, 38049090113949344, 87077595, 87077598, 3, 1366x768 
0x10EAE998, 38049090114622472, 87077663, 87077667, 4, 1366x768 
0x10EAE998, 38049090115296624, 87077731, 87077735, 4, 1366x768 
0x10EAE998, 38049090115962624, 87077797, 87077801, 4, 1366x768 
0x10EAE998, 38049090116635120, 87077865, 87077869, 4, 1366x768 
0x10EAE998, 38049090117307064, 87077950, 87077954, 4, 1366x768 
0x10EAE998, 38049090117968256, 87078017, 87078020, 3, 1366x768 
0x10EAE998, 38049090123306448, 87078553, 87078556, 3, 1366x768 
0x10EAE998, 38049090128671632, 87079068, 87079072, 4, 1366x768 
0x10EAE998, 38049090129348464, 87079136, 87079140, 4, 1366x768 
0x10EAE998, 38049090130013168, 87079202, 87079206, 4, 1366x768 
0x10EAE998, 38049090130682464, 87079269, 87079272, 3, 1366x768 
0x10EAE998, 38049090131352536, 87079338, 87079342, 4, 1366x768 
0x10EAE998, 38049090132028392, 87079403, 87079406, 3, 1366x768 
0x10EAE998, 38049090132694192, 87079471, 87079474, 3, 1366x768 
0x10EAE998, 38049090133365832, 87079539, 87079542, 3, 1366x768 
0x10EAE998, 38049090134033520, 87079602, 87079606, 4, 1366x768 
0x10EAE998, 38049090134700504, 87079671, 87079675, 4, 1366x768 
0x10EAE998, 38049090135374288, 87079738, 87079742, 4, 1366x768 
0x10EAE998, 38049090136044200, 87079804, 87079808, 4, 1366x768 
0x10EAE998, 38049090136716984, 87079875, 87079878, 3, 1366x768 
0x10EAE998, 38049090137388208, 87079939, 87079942, 3, 1366x768 
0x10EAE998, 38049090138060200, 87080006, 87080010, 4, 1366x768 
0x10EAE998, 38049090138735016, 87080073, 87080077, 4, 1366x768 
0x10EAE998, 38049090139405792, 87080142, 87080146, 4, 1366x768 
0x10EAE998, 38049090140077200, 87080210, 87080213, 3, 1366x768 
0x10EAE998, 38049090140744536, 87080276, 87080280, 4, 1366x768 
0x10EAE998, 38049090141412048, 87080360, 87080363, 3, 1366x768 
0x10EAE998, 38049090142083384, 87080429, 87080432, 3, 1366x768 
0x10EAE998, 38049090147417312, 87080960, 87080964, 4, 1366x768 
0x10EAE998, 38049090152762664, 87081498, 87081502, 4, 1366x768 
0x10EAE998, 38049090158091944, 87082032, 87082036, 4, 1366x768 
0x10EAE998, 38049090161434992, 87082362, 87082366, 4, 1366x768 
0x10EAE998, 38049090162102504, 87082434, 87082438, 4, 1366x768 
0x10EAE998, 38049090162770728, 87082517, 87082521, 4, 1366x768 
0x10EAE998, 38049090163440376, 87082559, 87082562, 3, 1366x768 
0x10EAE998, 38049090164107704, 87082614, 87082618, 4, 1366x768 
0x10EAE998, 38049090164782104, 87082679, 87082682, 3, 1366x768 
0x10EAE998, 38049090165455088, 87082746, 87082749, 3, 1366x768 
0x10EAE998, 38049090166121488, 87082811, 87082816, 5, 1366x768 
0x10EAE998, 38049090166791208, 87082882, 87082885, 3, 1366x768 
0x10EAE998, 38049090167456832, 87082945, 87082949, 4, 1366x768 
0x10EAE998, 38049090168124936, 87083011, 87083015, 4, 1366x768 
0x10EAE998, 38049090168792688, 87083079, 87083082, 3, 1366x768 
0x10EAE998, 38049090169463080, 87083146, 87083150, 4, 1366x768 
0x10EAE998, 38049090170150704, 87083223, 87083227, 4, 1366x768 
0x10EAE998, 38049090170817704, 87083282, 87083286, 4, 1366x768 
0x10EAE998, 38049090171481880, 87083353, 87083357, 4, 1366x768 
0x10EAE998, 38049090172139112, 87083425, 87083429, 4, 1366x768 
0x10EAE998, 38049090172807296, 87083484, 87083488, 4, 1366x768 
0x10EAE998, 38049090173475696, 87083549, 87083552, 3, 1366x768 
0x10EAE998, 38049090174144184, 87083617, 87083620, 3, 1366x768 
0x10EAE998, 38049090174812472, 87083683, 87083687, 4, 1366x768 
0x10EAE998, 38049090175480344, 87083749, 87083752, 3, 1366x768 
0x10EAE998, 38049090176148752, 87083818, 87083821, 3, 1366x768 
0x10EAE998, 38049090176822328, 87083885, 87083889, 4, 1366x768 
0x10EAE998, 38049090177512096, 87083962, 87083978, 16, 1366x768 
0x10EAE998, 38049090178187632, 87084040, 87084049, 9, 1366x768 
0x10EAE998, 38049090178856952, 87084095, 87084099, 4, 1366x768 
0x10EAE998, 38049090179698296, 87084228, 87084231, 3, 1366x768 
0x10EAE998, 38049090180361080, 87084257, 87084260, 3, 1366x768 
0x10EAE998, 38049090181030544, 87084305, 87084308, 3, 1366x768 
0x10EAE998, 38049090181706512, 87084377, 87084381, 4, 1366x768 
0x10EAE998, 38049090182369760, 87084436, 87084439, 3, 1366x768 
0x10EAE998, 38049090183038064, 87084523, 87084527, 4, 1366x768 
0x10EAE998, 38049090183706904, 87084577, 87084581, 4, 1366x768 
0x10EAE998, 38049090184378728, 87084638, 87084642, 4, 1366x768 
0x10EAE998, 38049090185045528, 87084724, 87084727, 3, 1366x768 
0x10EAE998, 38049090185716784, 87084774, 87084778, 4, 1366x768 
0x10EAE998, 38049090186384432, 87084837, 87084840, 3, 1366x768 
0x10EAE998, 38049090187055568, 87084905, 87084909, 4, 1366x768 
0x10EAE998, 38049090187723728, 87084972, 87084975, 3, 1366x768 
0x10EAE998, 38049090188398608, 87085043, 87085047, 4, 1366x768 
0x10EAE998, 38049090189070512, 87085110, 87085114, 4, 1366x768 
0x10EAE998, 38049090189744568, 87085199, 87085202, 3, 1366x768 
0x10EAE998, 38049090190418912, 87085265, 87085269, 4, 1366x768 
0x10EAE998, 38049090191088792, 87085330, 87085334, 4, 1366x768 
0x10EAE998, 38049090191755840, 87085395, 87085399, 4, 1366x768 
0x10EAE998, 38049090192424056, 87085463, 87085467, 4, 1366x768 
0x10EAE998, 38049090193094856, 87085530, 87085534, 4, 1366x768 
0x10EAE998, 38049090193759216, 87085596, 87085600, 4, 1366x768 
0x10EAE998, 38049090194431240, 87085666, 87085669, 3, 1366x768 
0x10EAE998, 38049090195103520, 87085731, 87085735, 4, 1366x768 
0x10EAE998, 38049090195763344, 87085798, 87085802, 4, 1366x768 
0x10EAE998, 38049090196429792, 87085863, 87085868, 5, 1366x768 
0x10EAE998, 38049090197098088, 87085911, 87085914, 3, 1366x768 
0x10EAE998, 38049090197766264, 87085977, 87085981, 4, 1366x768 
0x10EAE998, 38049090198434520, 87086044, 87086048, 4, 1366x768 
0x10EAE998, 38049090199102632, 87086134, 87086138, 4, 1366x768 
0x10EAE998, 38049090199771032, 87086177, 87086181, 4, 1366x768 
0x10EAE998, 38049090200439400, 87086248, 87086251, 3, 1366x768 
0x10EAE998, 38049090201102704, 87086330, 87086333, 3, 1366x768 
0x10EAE998, 38049090201770608, 87086396, 87086399, 3, 1366x768 
0x10EAE998, 38049090202438872, 87086468, 87086471, 3, 1366x768 
0x10EAE998, 38049090203107160, 87086533, 87086537, 4, 1366x768 
0x10EAE998, 38049090203773016, 87086597, 87086600, 3, 1366x768 
0x10EAE998, 38049090204440816, 87086667, 87086671, 4, 1366x768 
0x10EAE998, 38049090205108376, 87086732, 87086736, 4, 1366x768 
0x10EAE998, 38049090205773120, 87086778, 87086782, 4, 1366x768 
0x10EAE998, 38049090206438912, 87086866, 87086870, 4, 1366x768 
0x10EAE998, 38049090207107080, 87086914, 87086918, 4, 1366x768 
0x10EAE998, 38049090207775472, 87086981, 87086984, 3, 1366x768 
0x10EAE998, 38049090208443456, 87087045, 87087048, 3, 1366x768 
0x10EAE998, 38049090209112072, 87087131, 87087134, 3, 1366x768 
0x10EAE998, 38049090209779936, 87087196, 87087199, 3, 1366x768 
0x10EAE998, 38049090210448528, 87087271, 87087275, 4, 1366x768 
0x10EAE998, 38049090211116408, 87087336, 87087339, 3, 1366x768 
0x10EAE998, 38049090211785024, 87087400, 87087403, 3, 1366x768 
0x10EAE998, 38049090212452808, 87087445, 87087449, 4, 1366x768 
0x10EAE998, 38049090213121280, 87087517, 87087521, 4, 1366x768 
0x10EAE998, 38049090213798096, 87087580, 87087584, 4, 1366x768 
0x10EAE998, 38049090214465120, 87087669, 87087673, 4, 1366x768 
0x10EAE998, 38049090215130816, 87087734, 87087738, 4, 1366x768 
0x10EAE998, 38049090215799008, 87087801, 87087805, 4, 1366x768 
0x10EAE998, 38049090216467520, 87087848, 87087851, 3, 1366x768 
0x10EAE998, 38049090217130296, 87087934, 87087937, 3, 1366x768 
0x10EAE998, 38049090217798416, 87088004, 87088008, 4, 1366x768 
0x10EAE998, 38049090218465520, 87088068, 87088072, 4, 1366x768 
0x10EAE998, 38049090219132544, 87088136, 87088140, 4, 1366x768 
0x10EAE998, 38049090219805576, 87088202, 87088205, 3, 1366x768 
0x10EAE998, 38049090220464840, 87088265, 87088269, 4, 1366x768 
0x10EAE998, 38049090221131792, 87088328, 87088331, 3, 1366x768 
0x10EAE998, 38049090221798688, 87088379, 87088382, 3, 1366x768 
0x10EAE998, 38049090222471768, 87088448, 87088452, 4, 1366x768 
0x10EAE998, 38049090223145648, 87088537, 87088541, 4, 1366x768 
0x10EAE998, 38049090223817496, 87088600, 87088604, 4, 1366x768 
0x10EAE998, 38049090224483280, 87088667, 87088670, 3, 1366x768 
0x10EAE998, 38049090225153728, 87088740, 87088743, 3, 1366x768 
0x10EAE998, 38049090225817344, 87088804, 87088808, 4, 1366x768 
0x10EAE998, 38049090226486496, 87088870, 87088874, 4, 1366x768 
0x10EAE998, 38049090227152336, 87088937, 87088941, 4, 1366x768 
0x10EAE998, 38049090227817064, 87089000, 87089003, 3, 1366x768 
0x10EAE998, 38049090228477568, 87089067, 87089071, 4, 1366x768 
0x10EAE998, 38049090229147688, 87089137, 87089140, 3, 1366x768 
0x10EAE998, 38049090229818648, 87089204, 87089208, 4, 1366x768 
0x10EAE998, 38049090230477816, 87089266, 87089270, 4, 1366x768 
0x10EAE998, 38049090231142832, 87089336, 87089340, 4, 1366x768 
0x10EAE998, 38049090231821632, 87089404, 87089407, 3, 1366x768 
0x10EAE998, 38049090232490824, 87089470, 87089474, 4, 1366x768 
0x10EAE998, 38049090233159088, 87089537, 87089540, 3, 1366x768 
0x10EAE998, 38049090233833160, 87089588, 87089591, 3, 1366x768 
0x10EAE998, 38049090234495888, 87089652, 87089656, 4, 1366x768 
0x10EAE998, 38049090235157680, 87089738, 87089741, 3, 1366x768 
0x10EAE998, 38049090235829192, 87089783, 87089787, 4, 1366x768 
0x10EAE998, 38049090236496336, 87089851, 87089854, 3, 1366x768 
0x10EAE998, 38049090237172496, 87089941, 87089944, 3, 1366x768 
0x10EAE998, 38049090237833536, 87090002, 87090006, 4, 1366x768 
0x10EAE998, 38049090238510184, 87090073, 87090076, 3, 1366x768 
0x10EAE998, 38049090239184384, 87090141, 87090144, 3, 1366x768 
0x10EAE998, 38049090239860704, 87090209, 87090213, 4, 1366x768 
0x10EAE998, 38049090240530008, 87090253, 87090257, 4, 1366x768 
0x10EAE998, 38049090241197664, 87090321, 87090325, 4, 1366x768 
0x10EAE998, 38049090241865216, 87090391, 87090395, 4, 1366x768 
0x10EAE998, 38049090242531288, 87090455, 87090459, 4, 1366x768 
0x10EAE998, 38049090243204216, 87090523, 87090526, 3, 1366x768 
0x10EAE998, 38049090243869992, 87090589, 87090592, 3, 1366x768 
0x10EAE998, 38049090244538104, 87090689, 87090693, 4, 1366x768 
0x10EAE998, 38049090245206408, 87090723, 87090727, 4, 1366x768 
0x10EAE998, 38049090245875048, 87090790, 87090793, 3, 1366x768 
0x10EAE998, 38049090246542888, 87090853, 87090856, 3, 1366x768 
0x10EAE998, 38049090247212216, 87090924, 87090927, 3, 1366x768 
0x10EAE998, 38049090247879288, 87090989, 87090992, 3, 1366x768 
0x10EAE998, 38049090248547408, 87091054, 87091057, 3, 1366x768 
0x10EAE998, 38049090249216224, 87091142, 87091145, 3, 1366x768 
0x10EAE998, 38049090249882472, 87091209, 87091212, 3, 1366x768 
0x10EAE998, 38049090255222168, 87091745, 87091748, 3, 1366x768 
0x10EAE998, 38049090259229800, 87092126, 87092130, 4, 1366x768 
0x10EAE998, 38049090259897336, 87092214, 87092218, 4, 1366x768 
0x10EAE998, 38049090260559104, 87092276, 87092280, 4, 1366x768 
0x10EAE998, 38049090261896104, 87092392, 87092396, 4, 1366x768 
0x10EAE998, 38049090262556856, 87092458, 87092462, 4, 1366x768 
0x10EAE998, 38049090263224856, 87092524, 87092529, 5, 1366x768 
0x10EAE998, 38049090263893064, 87092592, 87092596, 4, 1366x768 
0x10EAE998, 38049090264569496, 87092659, 87092662, 3, 1366x768 
0x10EAE998, 38049090265241760, 87092727, 87092731, 4, 1366x768 
0x10EAE998, 38049090265914656, 87092793, 87092798, 5, 1366x768 
0x10EAE998, 38049090266583072, 87092859, 87092862, 3, 1366x768 
0x10EAE998, 38049090267248064, 87092928, 87092931, 3, 1366x768 
0x10EAE998, 38049090267908344, 87092990, 87092993, 3, 1366x768 
0x10EAE998, 38049090268573784, 87093057, 87093060, 3, 1366x768 
0x10EAE998, 38049090269246576, 87093147, 87093150, 3, 1366x768 
0x10EAE998, 38049090269910192, 87093192, 87093196, 4, 1366x768 
0x10EAE998, 38049090270578200, 87093257, 87093260, 3, 1366x768 
0x10EAE998, 38049090271255024, 87093345, 87093349, 4, 1366x768 
0x10EAE998, 38049090271922128, 87093411, 87093415, 4, 1366x768 
0x10EAE998, 38049090277283264, 87093948, 87093952, 4, 1366x768 
0x10EAE998, 38049090282624192, 87094486, 87094489, 3, 1366x768 
0x10EAE998, 38049090287957312, 87095015, 87095018, 3, 1366x768 
0x10EAE998, 38049090293283400, 87095549, 87095553, 4, 1366x768 
0x10EAE998, 38049090298612296, 87096081, 87096085, 4, 1366x768 
0x10EAE998, 38049090303949544, 87096618, 87096622, 4, 1366x768 
0x10EAE998, 38049090309286888, 87097131, 87097135, 4, 1366x768 
0x10EAE998, 38049090309958696, 87097198, 87097202, 4, 1366x768 
0x10EAE998, 38049090310633504, 87097285, 87097289, 4, 1366x768 
0x10EAE998, 38049090315973392, 87097818, 87097822, 4, 1366x768 
0x10EAE998, 38049090316636984, 87097881, 87097885, 4, 1366x768 
0x10EAE998, 38049090317306336, 87097931, 87097935, 4, 1366x768 
0x10EAE998, 38049090317973624, 87097996, 87097999, 3, 1366x768 
0x10EAE998, 38049090318643472, 87098065, 87098068, 3, 1366x768 
0x10EAE998, 38049090319309096, 87098138, 87098145, 7, 1366x768 
0x10EAE998, 38049090319973528, 87098197, 87098201, 4, 1366x768 
0x10EAE998, 38049090320641784, 87098266, 87098269, 3, 1366x768 
0x10EAE998, 38049090321314336, 87098334, 87098338, 4, 1366x768 
0x10EAE998, 38049090321975560, 87098398, 87098401, 3, 1366x768 
0x10EAE998, 38049090322643880, 87098467, 87098470, 3, 1366x768 
0x10EAE998, 38049090323301952, 87098532, 87098535, 3, 1366x768 
0x10EAE998, 38049090323959824, 87098601, 87098604, 3, 1366x768 
0x10EAE998, 38049090324623424, 87098662, 87098665, 3, 1366x768 
0x10EAE998, 38049090325290800, 87098729, 87098733, 4, 1366x768 
0x10EAE998, 38049090325948480, 87098813, 87098817, 4, 1366x768 
0x10EAE998, 38049090331283312, 87099351, 87099355, 4, 1366x768 
0x10EAE998, 38049090336602712, 87099880, 87099884, 4, 1366x768 
0x10EAE998, 38049090341954520, 87100418, 87100421, 3, 1366x768 
0x10EAE998, 38049090347294640, 87100948, 87100952, 4, 1366x768 
0x10EAE998, 38049090352633800, 87101484, 87101487, 3, 1366x768 
0x10EAE998, 38049090357957072, 87102014, 87102017, 3, 1366x768 
0x10EAE998, 38049090363280160, 87102550, 87102554, 4, 1366x768 
0x10EAE998, 38049090368620784, 87103081, 87103085, 4, 1366x768 
0x10EAE998, 38049090373952904, 87103615, 87103618, 3, 1366x768 
0x10EAE998, 38049090379300760, 87104152, 87104156, 4, 1366x768 
0x10EAE998, 38049090384640472, 87104685, 87104689, 4, 1366x768 
0x10EAE998, 38049090389981616, 87105218, 87105222, 4, 1366x768 
0x10EAE998, 38049090395309648, 87105752, 87105756, 4, 1366x768 
0x10EAE998, 38049090400663144, 87106284, 87106288, 4, 1366x768 
0x10EAE998, 38049090406014984, 87106824, 87106828, 4, 1366x768 
0x10EAE998, 38049090411354648, 87107357, 87107361, 4, 1366x768 
0x10EAE998, 38049090416682736, 87107887, 87107891, 4, 1366x768 
0x10EAE998, 38049090422040568, 87108425, 87108428, 3, 1366x768 
0x10EAE998, 38049090427372608, 87108957, 87108961, 4, 1366x768 
0x10EAE998, 38049090432714496, 87109490, 87109494, 4, 1366x768 
0x10EAE998, 38049090438074504, 87110026, 87110030, 4, 1366x768 
0x10EAE998, 38049090443434144, 87110565, 87110569, 4, 1366x768 
0x10EAE998, 38049090448782760, 87111100, 87111104, 4, 1366x768 
0x10EAE998, 38049090454110224, 87111631, 87111635, 4, 1366x768 
0x10EAE998, 38049090459437736, 87112165, 87112169, 4, 1366x768 
0x10EAE998, 38049090463418560, 87112547, 87112551, 4, 1366x768 
0x10EAE998, 38049090464090152, 87112611, 87112614, 3, 1366x768 
0x10EAE998, 38049090464755136, 87112679, 87112683, 4, 1366x768 
0x10EAE998, 38049090465417416, 87112746, 87112750, 4, 1366x768 
0x10EAE998, 38049090466089184, 87112814, 87112817, 3, 1366x768 
0x10EAE998, 38049090466757000, 87112880, 87112883, 3, 1366x768 
0x10EAE998, 38049090467425480, 87112945, 87112949, 4, 1366x768 
0x10EAE998, 38049090468095824, 87113013, 87113016, 3, 1366x768 
0x10EAE998, 38049090468763400, 87113098, 87113102, 4, 1366x768 
0x10EAE998, 38049090474077744, 87113629, 87113632, 3, 1366x768 
0x10EAE998, 38049090479437912, 87114165, 87114169, 4, 1366x768 
0x10EAE998, 38049090484774624, 87114697, 87114701, 4, 1366x768 
0x10EAE998, 38049090490124432, 87115235, 87115239, 4, 1366x768 
0x10EAE998, 38049090495461600, 87115764, 87115768, 4, 1366x768 
0x10EAE998, 38049090500804216, 87116305, 87116308, 3, 1366x768 
0x10EAE998, 38049090506135264, 87116835, 87116839, 4, 1366x768 
0x10EAE998, 38049090508149392, 87117015, 87117018, 3, 1366x768 
0x10EAE998, 38049090508818472, 87117083, 87117087, 4, 1366x768 
0x10EAE998, 38049090509485304, 87117149, 87117153, 4, 1366x768 
0x10EAE998, 38049090510151472, 87117217, 87117221, 4, 1366x768 
0x10EAE998, 38049090510821424, 87117285, 87117289, 4, 1366x768 
0x10EAE998, 38049090511485288, 87117351, 87117354, 3, 1366x768 
0x10EAE998, 38049090512155824, 87117419, 87117423, 4, 1366x768 
0x10EAE998, 38049090512824032, 87117485, 87117489, 4, 1366x768 
0x10EAE998, 38049090513482328, 87117547, 87117550, 3, 1366x768 
0x10EAE998, 38049090514150264, 87117619, 87117622, 3, 1366x768 
0x10EAE998, 38049090514824360, 87117684, 87117687, 3, 1366x768 
0x10EAE998, 38049090515493400, 87117748, 87117751, 3, 1366x768 
0x10EAE998, 38049090516163024, 87117818, 87117821, 3, 1366x768 
0x10EAE998, 38049090516832336, 87117886, 87117889, 3, 1366x768 
0x10EAE998, 38049090517502120, 87117953, 87117957, 4, 1366x768 
0x10EAE998, 38049090518169624, 87118017, 87118021, 4, 1366x768 
0x10EAE998, 38049090518830448, 87118105, 87118109, 4, 1366x768 
0x10EAE998, 38049090524165936, 87118639, 87118643, 4, 1366x768 
0x10EAE998, 38049090529505680, 87119174, 87119178, 4, 1366x768 
0x10EAE998, 38049090534846136, 87119706, 87119709, 3, 1366x768 
0x10EAE998, 38049090540207176, 87120244, 87120249, 5, 1366x768 
0x10EAE998, 38049090545538640, 87120774, 87120778, 4, 1366x768 
0x10EAE998, 38049090550879360, 87121310, 87121314, 4, 1366x768 
0x10EAE998, 38049090556220200, 87121843, 87121846, 3, 1366x768 
0x10EAE998, 38049090561552248, 87122374, 87122378, 4, 1366x768 
0x10EAE998, 38049090566881608, 87122909, 87122913, 4, 1366x768 
0x10EAE998, 38049090572226128, 87123441, 87123445, 4, 1366x768 
0x10EAE998, 38049090577529216, 87123971, 87123975, 4, 1366x768 
0x10EAE998, 38049090582880008, 87124506, 87124510, 4, 1366x768 
0x10EAE998, 38049090588214280, 87125040, 87125044, 4, 1366x768 
0x10EAE998, 38049090593548392, 87125577, 87125581, 4, 1366x768 
0x10EAE998, 38049090598905392, 87126112, 87126116, 4, 1366x768 
0x10EAE998, 38049090604261088, 87126645, 87126649, 4, 1366x768 
0x10EAE998, 38049090607598480, 87126962, 87126966, 4, 1366x768 
0x10EAE998, 38049090612943768, 87127515, 87127519, 4, 1366x768 
0x10EAE998, 38049090618287008, 87128047, 87128051, 4, 1366x768 
0x10EAE998, 38049090623635952, 87128583, 87128586, 3, 1366x768 
0x10EAE998, 38049090628979712, 87129119, 87129122, 3, 1366x768 
0x10EAE998, 38049090634335416, 87129656, 87129659, 3, 1366x768 
0x10EAE998, 38049090639675632, 87130187, 87130190, 3, 1366x768 
0x10EAE998, 38049090645017232, 87130723, 87130727, 4, 1366x768 
0x10EAE998, 38049090650334248, 87131256, 87131260, 4, 1366x768 
0x10EAE998, 38049090655670032, 87131789, 87131792, 3, 1366x768 
0x10EAE998, 38049090660991512, 87132321, 87132325, 4, 1366x768 
0x10EAE998, 38049090666338152, 87132853, 87132856, 3, 1366x768 
0x10EAE998, 38049090671675704, 87133389, 87133393, 4, 1366x768 
0x10EAE998, 38049090677023696, 87133924, 87133928, 4, 1366x768 
0x10EAE998, 38049090682385008, 87134461, 87134465, 4, 1366x768 
0x10EAE998, 38049090687736592, 87134992, 87134996, 4, 1366x768 
0x10EAE998, 38049090693082576, 87135530, 87135534, 4, 1366x768 
0x10EAE998, 38049090698418160, 87136064, 87136068, 4, 1366x768 
0x10EAE998, 38049090703743224, 87136594, 87136597, 3, 1366x768 
0x10EAE998, 38049090709091232, 87137131, 87137135, 4, 1366x768 
0x10EAE998, 38049090714431840, 87137665, 87137668, 3, 1366x768 
0x10EAE998, 38049090719776776, 87138196, 87138199, 3, 1366x768 
0x10EAE998, 38049090725116512, 87138732, 87138735, 3, 1366x768 
0x10EAE998, 38049090730460464, 87139264, 87139268, 4, 1366x768 
0x10EAE998, 38049090735820160, 87139802, 87139806, 4, 1366x768 
0x10EAE998, 38049090741168760, 87140337, 87140341, 4, 1366x768 
0x10EAE998, 38049090746504648, 87140872, 87140876, 4, 1366x768 
0x10EAE998, 38049090751835144, 87141405, 87141408, 3, 1366x768 
0x10EAE998, 38049090757182488, 87141938, 87141941, 3, 1366x768 
0x10EAE998, 38049090762523856, 87142471, 87142474, 3, 1366x768 
0x10EAE998, 38049090767867336, 87143008, 87143012, 4, 1366x768 
0x10EAE998, 38049090773232616, 87143542, 87143546, 4, 1366x768 
0x10EAE998, 38049090778558152, 87144077, 87144080, 3, 1366x768 
0x10EAE998, 38049090783890080, 87144610, 87144613, 3, 1366x768 
0x10EAE998, 38049090789219240, 87145141, 87145145, 4, 1366x768 
0x10EAE998, 38049090794555936, 87145678, 87145682, 4, 1366x768 
0x10EAE998, 38049090799902336, 87146211, 87146214, 3, 1366x768 
0x10EAE998, 38049090805252272, 87146748, 87146752, 4, 1366x768 
0x10EAE998, 38049090810588928, 87147278, 87147281, 3, 1366x768 
0x10EAE998, 38049090815922192, 87147814, 87147818, 4, 1366x768 
0x10EAE998, 38049090821291328, 87148349, 87148353, 4, 1366x768 
0x10EAE998, 38049090826623568, 87148882, 87148886, 4, 1366x768 
0x10EAE998, 38049090831966864, 87149417, 87149421, 4, 1366x768 
0x10EAE998, 38049090837321096, 87149954, 87149958, 4, 1366x768 
0x10EAE998, 38049090842657928, 87150487, 87150491, 4, 1366x768 
0x10EAE998, 38049090848061256, 87151025, 87151028, 3, 1366x768 
0x10EAE998, 38049090853400320, 87151563, 87151567, 4, 1366x768 
0x10EAE998, 38049090858718816, 87152094, 87152098, 4, 1366x768 
0x10EAE998, 38049090864078152, 87152632, 87152635, 3, 1366x768 
0x10EAE998, 38049090869413240, 87153162, 87153165, 3, 1366x768 
0x10EAE998, 38049090874746288, 87153697, 87153701, 4, 1366x768 
0x10EAE998, 38049090880091080, 87154228, 87154232, 4, 1366x768 
0x10EAE998, 38049090885434848, 87154763, 87154766, 3, 1366x768 
0x10EAE998, 38049090890764120, 87155296, 87155300, 4, 1366x768 
0x10EAE998, 38049090896108632, 87155831, 87155835, 4, 1366x768 
0x10EAE998, 38049090901478432, 87156369, 87156373, 4, 1366x768 
0x10EAE998, 38049090906827544, 87156905, 87156909, 4, 1366x768 
0x10EAE998, 38049090912190480, 87157440, 87157444, 4, 1366x768 
0x10EAE998, 38049090917534944, 87157972, 87157975, 3, 1366x768 
0x10EAE998, 38049090922881240, 87158511, 87158514, 3, 1366x768 
0x10EAE998, 38049090928233224, 87159042, 87159046, 4, 1366x768 
0x10EAE998, 38049090933575568, 87159577, 87159580, 3, 1366x768 
0x10EAE998, 38049090938912960, 87160113, 87160117, 4, 1366x768 
0x10EAE998, 38049090944236736, 87160642, 87160646, 4, 1366x768 
0x10EAE998, 38049090949566368, 87161179, 87161183, 4, 1366x768 
0x10EAE998, 38049090954900520, 87161712, 87161716, 4, 1366x768 
0x10EAE998, 38049090960231280, 87162244, 87162247, 3, 1366x768 
0x10EAE998, 38049090965568232, 87162777, 87162781, 4, 1366x768 
0x10EAE998, 38049090970905888, 87163309, 87163312, 3, 1366x768 
0x10EAE998, 38049090976251984, 87163845, 87163848, 3, 1366x768 
0x10EAE998, 38049090981577888, 87164377, 87164381, 4, 1366x768 
0x10EAE998, 38049090986919296, 87164914, 87164918, 4, 1366x768 
0x10EAE998, 38049090992268640, 87165446, 87165450, 4, 1366x768 
0x10EAE998, 38049090997613592, 87165983, 87165987, 4, 1366x768 
0x10EAE998, 38049091002942872, 87166515, 87166518, 3, 1366x768 
0x10EAE998, 38049091008284488, 87167050, 87167054, 4, 1366x768 
0x10EAE998, 38049091013622800, 87167585, 87167589, 4, 1366x768 
0x10EAE998, 38049091018956632, 87168114, 87168118, 4, 1366x768 
0x10EAE998, 38049091024300432, 87168649, 87168653, 4, 1366x768 
0x10EAE998, 38049091029648512, 87169187, 87169191, 4, 1366x768 
0x10EAE998, 38049091034978040, 87169718, 87169721, 3, 1366x768 
0x10EAE998, 38049091040303384, 87170251, 87170254, 3, 1366x768 
0x10EAE998, 38049091045635040, 87170787, 87170790, 3, 1366x768 
0x10EAE998, 38049091050975144, 87171317, 87171321, 4, 1366x768 
0x10EAE998, 38049091056312576, 87171849, 87171852, 3, 1366x768 
0x10EAE998, 38049091061644040, 87172386, 87172390, 4, 1366x768 
0x10EAE998, 38049091066969952, 87172916, 87172919, 3, 1366x768 
0x10EAE998, 38049091072309440, 87173453, 87173457, 4, 1366x768 
0x10EAE998, 38049091077647680, 87173984, 87173987, 3, 1366x768 
0x10EAE998, 38049091082980288, 87174517, 87174520, 3, 1366x768 
0x10EAE998, 38049091088321928, 87175052, 87175056, 4, 1366x768 
0x10EAE998, 38049091093677768, 87175591, 87175594, 3, 1366x768 
0x10EAE998, 38049091099023352, 87176124, 87176127, 3, 1366x768 
0x10EAE998, 38049091104360056, 87176656, 87176660, 4, 1366x768 
0x10EAE998, 38049091109679608, 87177192, 87177195, 3, 1366x768 
0x10EAE998, 38049091115025400, 87177726, 87177730, 4, 1366x768 
0x10EAE998, 38049091120362360, 87178259, 87178263, 4, 1366x768 
0x10EAE998, 38049091125709536, 87178790, 87178793, 3, 1366x768 
0x10EAE998, 38049091129720176, 87179172, 87179175, 3, 1366x768 
0x10EAE998, 38049091130378352, 87179238, 87179241, 3, 1366x768 
0x10EAE998, 38049091131046560, 87179311, 87179314, 3, 1366x768 
0x10EAE998, 38049091135063232, 87179724, 87179727, 3, 1366x768 
0x10EAE998, 38049091135722056, 87179777, 87179780, 3, 1366x768 
0x10EAE998, 38049091136387320, 87179840, 87179843, 3, 1366x768 
0x10EAE998, 38049091137058888, 87179907, 87179910, 3, 1366x768 
0x10EAE998, 38049091137718464, 87179974, 87179978, 4, 1366x768 
0x10EAE998, 38049091138392000, 87180039, 87180042, 3, 1366x768 
0x10EAE998, 38049091139066072, 87180109, 87180113, 4, 1366x768 
0x10EAE998, 38049091139736120, 87180177, 87180180, 3, 1366x768 
0x10EAE998, 38049091140412056, 87180246, 87180250, 4, 1366x768 
0x10EAE998, 38049091141081016, 87180308, 87180312, 4, 1366x768 
0x10EAE998, 38049091141748488, 87180376, 87180379, 3, 1366x768 
0x10EAE998, 38049091142422120, 87180444, 87180448, 4, 1366x768 
0x10EAE998, 38049091143092824, 87180514, 87180518, 4, 1366x768 
0x10EAE998, 38049091143761448, 87180578, 87180582, 4, 1366x768 
0x10EAE998, 38049091144435048, 87180646, 87180650, 4, 1366x768 
0x10EAE998, 38049091145106816, 87180714, 87180717, 3, 1366x768 
0x10EAE998, 38049091145778008, 87180782, 87180792, 10, 1366x768 
0x10EAE998, 38049091146446392, 87180846, 87180849, 3, 1366x768 
0x10EAE998, 38049091147114664, 87180933, 87180936, 3, 1366x768 
0x10EAE998, 38049091150446056, 87181254, 87181258, 4, 1366x768 
0x10EAE998, 38049091151782216, 87181380, 87181383, 3, 1366x768 
0x10EAE998, 38049091152456216, 87181448, 87181452, 4, 1366x768 
0x10EAE998, 38049091153125376, 87181515, 87181518, 3, 1366x768 
0x10EAE998, 38049091153791808, 87181581, 87181584, 3, 1366x768 
0x10EAE998, 38049091154458272, 87181648, 87181652, 4, 1366x768 
0x10EAE998, 38049091155124984, 87181714, 87181717, 3, 1366x768 
0x10EAE998, 38049091155792512, 87181778, 87181782, 4, 1366x768 
0x10EAE998, 38049091156460648, 87181850, 87181854, 4, 1366x768 
0x10EAE998, 38049091157131496, 87181911, 87181915, 4, 1366x768 
0x10EAE998, 38049091157799024, 87181980, 87181984, 4, 1366x768 
0x10EAE998, 38049091158469368, 87182049, 87182053, 4, 1366x768 
0x10EAE998, 38049091159132544, 87182111, 87182115, 4, 1366x768 
0x10EAE998, 38049091159806472, 87182184, 87182188, 4, 1366x768 
0x10EAE998, 38049091160481512, 87182252, 87182256, 4, 1366x768 
0x10EAE998, 38049091161139264, 87182314, 87182317, 3, 1366x768 
0x10EAE998, 38049091161797936, 87182385, 87182388, 3, 1366x768 
0x10EAE998, 38049091162465760, 87182448, 87182452, 4, 1366x768 
0x10EAE998, 38049091163129888, 87182513, 87182516, 3, 1366x768 
0x10EAE998, 38049091163796816, 87182583, 87182586, 3, 1366x768 
0x10EAE998, 38049091164469288, 87182651, 87182655, 4, 1366x768 
0x10EAE998, 38049091165138368, 87182715, 87182718, 3, 1366x768 
0x10EAE998, 38049091165815576, 87182784, 87182788, 4, 1366x768 
0x10EAE998, 38049091166486176, 87182850, 87182853, 3, 1366x768 
0x10EAE998, 38049091167150936, 87182915, 87182918, 3, 1366x768 
0x10EAE998, 38049091167817872, 87182980, 87182984, 4, 1366x768 
0x10EAE998, 38049091168484704, 87183052, 87183056, 4, 1366x768 
0x10EAE998, 38049091169153464, 87183114, 87183118, 4, 1366x768 
0x10EAE998, 38049091169819608, 87183181, 87183185, 4, 1366x768 
0x10EAE998, 38049091170488880, 87183248, 87183251, 3, 1366x768 
0x10EAE998, 38049091171161152, 87183318, 87183321, 3, 1366x768 
0x10EAE998, 38049091171838056, 87183387, 87183390, 3, 1366x768 
0x10EAE998, 38049091172504184, 87183454, 87183457, 3, 1366x768 
0x10EAE998, 38049091173174968, 87183517, 87183521, 4, 1366x768 
0x10EAE998, 38049091173849664, 87183585, 87183589, 4, 1366x768 
0x10EAE998, 38049091174521848, 87183651, 87183655, 4, 1366x768 
0x10EAE998, 38049091175179832, 87183721, 87183724, 3, 1366x768 
0x10EAE998, 38049091175848200, 87183786, 87183789, 3, 1366x768 
0x10EAE998, 38049091176513280, 87183855, 87183858, 3, 1366x768 
0x10EAE998, 38049091177181080, 87183919, 87183923, 4, 1366x768 
0x10EAE998, 38049091177854832, 87183987, 87183990, 3, 1366x768 
0x10EAE998, 38049091178524840, 87184055, 87184059, 4, 1366x768 
0x10EAE998, 38049091179190400, 87184139, 87184143, 4, 1366x768 
0x10EAE998, 38049091184543736, 87184673, 87184677, 4, 1366x768 
0x10EAE998, 38049091189886816, 87185211, 87185215, 4, 1366x768 
0x10EAE998, 38049091195210392, 87185741, 87185744, 3, 1366x768 
0x10EAE998, 38049091200553656, 87186273, 87186277, 4, 1366x768 
0x10EAE998, 38049091205890432, 87186811, 87186815, 4, 1366x768 
0x10EAE998, 38049091207226112, 87186937, 87186941, 4, 1366x768 
0x10EAE998, 38049091212559808, 87187477, 87187480, 3, 1366x768 
0x10EAE998, 38049091217884168, 87188008, 87188012, 4, 1366x768 
0x10EAE998, 38049091223226976, 87188525, 87188528, 3, 1366x768 
0x10EAE998, 38049091223888248, 87188589, 87188593, 4, 1366x768 
0x10EAE998, 38049091224556744, 87188658, 87188661, 3, 1366x768 
0x10EAE998, 38049091225219320, 87188726, 87188730, 4, 1366x768 
0x10EAE998, 38049091225891808, 87188792, 87188795, 3, 1366x768 
0x10EAE998, 38049091226566640, 87188859, 87188863, 4, 1366x768 
0x10EAE998, 38049091227242320, 87188928, 87188932, 4, 1366x768 
0x10EAE998, 38049091227910936, 87188993, 87188996, 3, 1366x768 
0x10EAE998, 38049091228579040, 87189062, 87189066, 4, 1366x768 
0x10EAE998, 38049091229246872, 87189126, 87189129, 3, 1366x768 
0x10EAE998, 38049091229921008, 87189194, 87189198, 4, 1366x768 
0x10EAE998, 38049091230593856, 87189262, 87189265, 3, 1366x768 
0x10EAE998, 38049091231261376, 87189326, 87189330, 4, 1366x768 
0x10EAE998, 38049091231932088, 87189395, 87189398, 3, 1366x768 
0x10EAE998, 38049091232607104, 87189463, 87189467, 4, 1366x768 
0x10EAE998, 38049091233270752, 87189530, 87189533, 3, 1366x768 
0x10EAE998, 38049091233935112, 87189598, 87189601, 3, 1366x768 
0x10EAE998, 38049091234601672, 87189658, 87189662, 4, 1366x768 
0x10EAE998, 38049091235268528, 87189730, 87189734, 4, 1366x768 
0x10EAE998, 38049091235937480, 87189794, 87189798, 4, 1366x768 
0x10EAE998, 38049091236604224, 87189880, 87189883, 3, 1366x768 
0x10EAE998, 38049091241266144, 87190330, 87190333, 3, 1366x768 
0x10EAE998, 38049091241937208, 87190398, 87190401, 3, 1366x768 
0x10EAE998, 38049091242614560, 87190461, 87190466, 5, 1366x768 
0x10EAE998, 38049091243278256, 87190532, 87190535, 3, 1366x768 
0x10EAE998, 38049091243944720, 87190593, 87190595, 2, 1366x768 
0x10EAE998, 38049091244613592, 87190682, 87190685, 3, 1366x768 
0x10EAE998, 38049091245284936, 87190740, 87190743, 3, 1366x768 
0x10EAE998, 38049091245958872, 87190796, 87190799, 3, 1366x768 
0x10EAE998, 38049091246635392, 87190865, 87190868, 3, 1366x768 
0x10EAE998, 38049091247307688, 87190933, 87190936, 3, 1366x768 
0x10EAE998, 38049091247969256, 87190998, 87191001, 3, 1366x768 
0x10EAE998, 38049091248638024, 87191064, 87191067, 3, 1366x768 
0x10EAE998, 38049091249305184, 87191153, 87191157, 4, 1366x768 
0x10EAE998, 38049091249973608, 87191202, 87191206, 4, 1366x768 
0x10EAE998, 38049091250647360, 87191264, 87191268, 4, 1366x768 
0x10EAE998, 38049091251319048, 87191334, 87191337, 3, 1366x768 
0x10EAE998, 38049091251986552, 87191417, 87191420, 3, 1366x768 
0x10EAE998, 38049091257327712, 87191952, 87191956, 4, 1366x768 
0x10EAE998, 38049091262665840, 87192488, 87192492, 4, 1366x768 
0x10EAE998, 38049091266683760, 87192868, 87192871, 3, 1366x768 
0x10EAE998, 38049091267355472, 87192935, 87192938, 3, 1366x768 
0x10EAE998, 38049091268029824, 87193008, 87193012, 4, 1366x768 
0x10EAE998, 38049091268700520, 87193070, 87193073, 3, 1366x768 
0x10EAE998, 38049091269366088, 87193137, 87193140, 3, 1366x768 
0x10EAE998, 38049091270038672, 87193208, 87193212, 4, 1366x768 
0x10EAE998, 38049091270713720, 87193275, 87193279, 4, 1366x768 
0x10EAE998, 38049091271379424, 87193360, 87193363, 3, 1366x768 
0x10EAE998, 38049091272048392, 87193405, 87193408, 3, 1366x768 
0x10EAE998, 38049091272717360, 87193493, 87193497, 4, 1366x768 
0x10EAE998, 38049091277401024, 87193938, 87193942, 4, 1366x768 
0x10EAE998, 38049091278075864, 87194008, 87194012, 4, 1366x768 
0x10EAE998, 38049091278744928, 87194077, 87194080, 3, 1366x768 
0x10EAE998, 38049091279411752, 87194140, 87194144, 4, 1366x768 
0x10EAE998, 38049091280081504, 87194227, 87194231, 4, 1366x768 
0x10EAE998, 38049091283438672, 87194566, 87194570, 4, 1366x768 
0x10EAE998, 38049091284100096, 87194610, 87194614, 4, 1366x768 
0x10EAE998, 38049091284770328, 87194680, 87194684, 4, 1366x768 
0x10EAE998, 38049091285444056, 87194746, 87194750, 4, 1366x768 
0x10EAE998, 38049091286105856, 87194815, 87194819, 4, 1366x768 
0x10EAE998, 38049091286771864, 87194876, 87194880, 4, 1366x768 
0x10EAE998, 38049091287439712, 87194945, 87194949, 4, 1366x768 
0x10EAE998, 38049091288108248, 87195014, 87195018, 4, 1366x768 
0x10EAE998, 38049091288777368, 87195097, 87195100, 3, 1366x768 
0x10EAE998, 38049091289443536, 87195143, 87195147, 4, 1366x768 
0x10EAE998, 38049091290115648, 87195211, 87195214, 3, 1366x768 
0x10EAE998, 38049091290783592, 87195298, 87195302, 4, 1366x768 
0x10EAE998, 38049091296130008, 87195835, 87195839, 4, 1366x768 
0x10EAE998, 38049091301467432, 87196349, 87196352, 3, 1366x768 
0x10EAE998, 38049091302134600, 87196416, 87196419, 3, 1366x768 
0x10EAE998, 38049091302803936, 87196481, 87196485, 4, 1366x768 
0x10EAE998, 38049091303476832, 87196571, 87196575, 4, 1366x768 
0x10EAE998, 38049091306146152, 87196816, 87196819, 3, 1366x768 
0x10EAE998, 38049091306818048, 87196881, 87196884, 3, 1366x768 
0x10EAE998, 38049091307482016, 87196948, 87196952, 4, 1366x768 
0x10EAE998, 38049091308155560, 87197015, 87197019, 4, 1366x768 
0x10EAE998, 38049091308824480, 87197082, 87197087, 5, 1366x768 
0x10EAE998, 38049091309495136, 87197151, 87197154, 3, 1366x768 
0x10EAE998, 38049091310163104, 87197240, 87197244, 4, 1366x768 
0x10EAE998, 38049091311493776, 87197352, 87197355, 3, 1366x768 
0x10EAE998, 38049091312158856, 87197417, 87197420, 3, 1366x768 
0x10EAE998, 38049091312827512, 87197485, 87197488, 3, 1366x768 
0x10EAE998, 38049091313495056, 87197571, 87197575, 4, 1366x768 
0x10EAE998, 38049091314829880, 87197686, 87197690, 4, 1366x768 
0x10EAE998, 38049091315503776, 87197751, 87197755, 4, 1366x768 
0x10EAE998, 38049091316172184, 87197836, 87197839, 3, 1366x768 
0x10EAE998, 38049091318165832, 87198015, 87198018, 3, 1366x768 
0x10EAE998, 38049091318833704, 87198082, 87198086, 4, 1366x768 
0x10EAE998, 38049091319504680, 87198151, 87198154, 3, 1366x768 
0x10EAE998, 38049091320169176, 87198219, 87198222, 3, 1366x768 
0x10EAE998, 38049091320838800, 87198286, 87198290, 4, 1366x768 
0x10EAE998, 38049091322170712, 87198438, 87198442, 4, 1366x768 
0x10EAE998, 38049091322840816, 87198489, 87198492, 3, 1366x768 
0x10EAE998, 38049091323509072, 87198553, 87198557, 4, 1366x768 
0x10EAE998, 38049091324172304, 87198617, 87198620, 3, 1366x768 
0x10EAE998, 38049091324841208, 87198687, 87198691, 4, 1366x768 
0x10EAE998, 38049091325513240, 87198753, 87198757, 4, 1366x768 
0x10EAE998, 38049091326181416, 87198817, 87198820, 3, 1366x768 
0x10EAE998, 38049091326848032, 87198885, 87198889, 4, 1366x768 
0x10EAE998, 38049091327518096, 87198951, 87198955, 4, 1366x768 
0x10EAE998, 38049091328189768, 87199018, 87199022, 4, 1366x768 
0x10EAE998, 38049091328861952, 87199108, 87199112, 4, 1366x768 
0x10EAE998, 38049091332197312, 87199432, 87199437, 5, 1366x768 
0x10EAE998, 38049091334868552, 87199697, 87199701, 4, 1366x768 
0x10EAE998, 38049091335537600, 87199757, 87199761, 4, 1366x768 
0x10EAE998, 38049091336204168, 87199819, 87199823, 4, 1366x768 
0x10EAE998, 38049091336877056, 87199888, 87199892, 4, 1366x768 
0x10EAE998, 38049091338218488, 87200025, 87200028, 3, 1366x768 
0x10EAE998, 38049091338887224, 87200093, 87200097, 4, 1366x768 
0x10EAE998, 38049091342229056, 87200425, 87200429, 4, 1366x768 
0x10EAE998, 38049091342896800, 87200493, 87200496, 3, 1366x768 
0x10EAE998, 38049091344895104, 87200688, 87200692, 4, 1366x768 
0x10EAE998, 38049091345567944, 87200758, 87200761, 3, 1366x768 
0x10EAE998, 38049091350899192, 87201309, 87201313, 4, 1366x768 
0x10EAE998, 38049091351566304, 87201365, 87201369, 4, 1366x768 
0x10EAE998, 38049091352239360, 87201433, 87201437, 4, 1366x768 
0x10EAE998, 38049091352906848, 87201491, 87201494, 3, 1366x768 
0x10EAE998, 38049091353572840, 87201557, 87201561, 4, 1366x768 
0x10EAE998, 38049091354246400, 87201644, 87201648, 4, 1366x768 
0x10EAE998, 38049091359588728, 87202181, 87202185, 4, 1366x768 
0x10EAE998, 38049091364929816, 87202693, 87202697, 4, 1366x768 
0x10EAE998, 38049091365601584, 87202760, 87202763, 3, 1366x768 
0x10EAE998, 38049091366266192, 87202828, 87202831, 3, 1366x768 
0x10EAE998, 38049091366946888, 87202898, 87202902, 4, 1366x768 
0x10EAE998, 38049091367624696, 87202981, 87202984, 3, 1366x768 
0x10EAE998, 38049091372960776, 87203514, 87203517, 3, 1366x768 
0x10EAE998, 38049091374962680, 87203701, 87203705, 4, 1366x768 
0x10EAE998, 38049091375634904, 87203787, 87203791, 4, 1366x768 
0x10EAE998, 38049091380989928, 87204320, 87204323, 3, 1366x768 
0x10EAE998, 38049091385003160, 87204718, 87204722, 4, 1366x768 
0x10EAE998, 38049091390360448, 87205258, 87205261, 3, 1366x768 
0x10EAE998, 38049091395684256, 87205789, 87205792, 3, 1366x768 
0x10EAE998, 38049091401006712, 87206319, 87206323, 4, 1366x768 
0x10EAE998, 38049091406348624, 87206857, 87206860, 3, 1366x768 
0x10EAE998, 38049091411684064, 87207389, 87207393, 4, 1366x768 
0x10EAE998, 38049091417026704, 87207923, 87207926, 3, 1366x768 
0x10EAE998, 38049091422357800, 87208458, 87208462, 4, 1366x768 
0x10EAE998, 38049091427705896, 87208993, 87208996, 3, 1366x768 
0x10EAE998, 38049091433045720, 87209526, 87209530, 4, 1366x768 
0x10EAE998, 38049091438394600, 87210059, 87210063, 4, 1366x768 
0x10EAE998, 38049091443735040, 87210592, 87210595, 3, 1366x768 
0x10EAE998, 38049091449064744, 87211128, 87211131, 3, 1366x768 
0x10EAE998, 38049091454386288, 87211662, 87211665, 3, 1366x768 
0x10EAE998, 38049091459735472, 87212192, 87212195, 3, 1366x768 
0x10EAE998, 38049091465082576, 87212727, 87212731, 4, 1366x768 
0x10EAE998, 38049091470419144, 87213259, 87213263, 4, 1366x768 
0x10EAE998, 38049091475762864, 87213799, 87213802, 3, 1366x768 
0x10EAE998, 38049091481093144, 87214329, 87214333, 4, 1366x768 
0x10EAE998, 38049091486425192, 87214863, 87214867, 4, 1366x768 
0x10EAE998, 38049091491759560, 87215396, 87215399, 3, 1366x768 
0x10EAE998, 38049091497104216, 87215928, 87215933, 5, 1366x768 
0x10EAE998, 38049091499096632, 87216113, 87216117, 4, 1366x768 
0x10EAE998, 38049091502440016, 87216447, 87216450, 3, 1366x768 
0x10EAE998, 38049091503103624, 87216521, 87216525, 4, 1366x768 
0x10EAE998, 38049091503770232, 87216579, 87216582, 3, 1366x768 
0x10EAE998, 38049091504447200, 87216646, 87216649, 3, 1366x768 
0x10EAE998, 38049091505783392, 87216797, 87216800, 3, 1366x768 
0x10EAE998, 38049091506442720, 87216866, 87216869, 3, 1366x768 
0x10EAE998, 38049091507765936, 87216980, 87216983, 3, 1366x768 
0x10EAE998, 38049091508434688, 87217047, 87217051, 4, 1366x768 
0x10EAE998, 38049091511782472, 87217381, 87217384, 3, 1366x768 
0x10EAE998, 38049091512450024, 87217444, 87217448, 4, 1366x768 
0x10EAE998, 38049091513122496, 87217513, 87217517, 4, 1366x768 
0x10EAE998, 38049091513796424, 87217582, 87217585, 3, 1366x768 
0x10EAE998, 38049091514467568, 87217666, 87217669, 3, 1366x768 
0x10EAE998, 38049091519817936, 87218200, 87218203, 3, 1366x768 
0x10EAE998, 38049091525159944, 87218740, 87218743, 3, 1366x768 
0x10EAE998, 38049091530501080, 87219268, 87219272, 4, 1366x768 
0x10EAE998, 38049091535839136, 87219803, 87219806, 3, 1366x768 
0x10EAE998, 38049091541162184, 87220338, 87220342, 4, 1366x768 
0x10EAE998, 38049091543173552, 87220519, 87220523, 4, 1366x768 
0x10EAE998, 38049091543841672, 87220587, 87220591, 4, 1366x768 
0x10EAE998, 38049091544512544, 87220673, 87220676, 3, 1366x768 
0x10EAE998, 38049091549859848, 87221208, 87221212, 4, 1366x768 
0x10EAE998, 38049091551849528, 87221388, 87221392, 4, 1366x768 
0x10EAE998, 38049091552520584, 87221453, 87221457, 4, 1366x768 
0x10EAE998, 38049091553188528, 87221525, 87221529, 4, 1366x768 
0x10EAE998, 38049091553855912, 87221590, 87221594, 4, 1366x768 
0x10EAE998, 38049091554526184, 87221656, 87221659, 3, 1366x768 
0x10EAE998, 38049091555197688, 87221720, 87221724, 4, 1366x768 
0x10EAE998, 38049091555865936, 87221792, 87221796, 4, 1366x768 
0x10EAE998, 38049091556547472, 87221863, 87221869, 6, 1366x768 
0x10EAE998, 38049091557212712, 87221923, 87221926, 3, 1366x768 
0x10EAE998, 38049091557885632, 87221993, 87221996, 3, 1366x768 
0x10EAE998, 38049091562564888, 87222459, 87222462, 3, 1366x768 
0x10EAE998, 38049091563237504, 87222525, 87222529, 4, 1366x768 
0x10EAE998, 38049091563903832, 87222607, 87222611, 4, 1366x768 
0x10EAE998, 38049091565905464, 87222791, 87222794, 3, 1366x768 
0x10EAE998, 38049091566575320, 87222859, 87222862, 3, 1366x768 
0x10EAE998, 38049091567247072, 87222930, 87222933, 3, 1366x768 
0x10EAE998, 38049091567913680, 87222994, 87222997, 3, 1366x768 
0x10EAE998, 38049091570584728, 87223267, 87223271, 4, 1366x768 
0x10EAE998, 38049091571260728, 87223324, 87223327, 3, 1366x768 
0x10EAE998, 38049091571928064, 87223392, 87223395, 3, 1366x768 
0x10EAE998, 38049091572594312, 87223460, 87223464, 4, 1366x768 
0x10EAE998, 38049091573265544, 87223528, 87223531, 3, 1366x768 
0x10EAE998, 38049091573937880, 87223595, 87223599, 4, 1366x768 
0x10EAE998, 38049091574612712, 87223664, 87223667, 3, 1366x768 
0x10EAE998, 38049091575279680, 87223729, 87223733, 4, 1366x768 
0x10EAE998, 38049091575950944, 87223796, 87223799, 3, 1366x768 
0x10EAE998, 38049091576614496, 87223863, 87223866, 3, 1366x768 
0x10EAE998, 38049091577288504, 87223928, 87223932, 4, 1366x768 
0x10EAE998, 38049091577954088, 87224001, 87224005, 4, 1366x768 
0x10EAE998, 38049091578621904, 87224062, 87224065, 3, 1366x768 
0x10EAE998, 38049091579289776, 87224132, 87224135, 3, 1366x768 
0x10EAE998, 38049091579962112, 87224199, 87224203, 4, 1366x768 
0x10EAE998, 38049091580633856, 87224266, 87224269, 3, 1366x768 
0x10EAE998, 38049091581300472, 87224330, 87224334, 4, 1366x768 
0x10EAE998, 38049091581966512, 87224399, 87224402, 3, 1366x768 
0x10EAE998, 38049091582651376, 87224464, 87224468, 4, 1366x768 
0x10EAE998, 38049091583316752, 87224532, 87224535, 3, 1366x768 
0x10EAE998, 38049091583986976, 87224602, 87224605, 3, 1366x768 
0x10EAE998, 38049091584659344, 87224670, 87224674, 4, 1366x768 
0x10EAE998, 38049091585326480, 87224731, 87224735, 4, 1366x768 
0x10EAE998, 38049091585997600, 87224804, 87224808, 4, 1366x768 
0x10EAE998, 38049091586661320, 87224865, 87224868, 3, 1366x768 
0x10EAE998, 38049091587332768, 87224932, 87224936, 4, 1366x768 
0x10EAE998, 38049091587998592, 87225002, 87225006, 4, 1366x768 
0x10EAE998, 38049091588669616, 87225068, 87225072, 4, 1366x768 
0x10EAE998, 38049091589333896, 87225135, 87225139, 4, 1366x768 
0x10EAE998, 38049091590010432, 87225201, 87225205, 4, 1366x768 
0x10EAE998, 38049091590678872, 87225269, 87225273, 4, 1366x768 
0x10EAE998, 38049091591341128, 87225336, 87225340, 4, 1366x768 
0x10EAE998, 38049091592011712, 87225404, 87225408, 4, 1366x768 
0x10EAE998, 38049091592682576, 87225476, 87225480, 4, 1366x768 
0x10EAE998, 38049091593350120, 87225536, 87225540, 4, 1366x768 
0x10EAE998, 38049091594016696, 87225603, 87225606, 3, 1366x768 
0x10EAE998, 38049091594687760, 87225672, 87225676, 4, 1366x768 
0x10EAE998, 38049091595357360, 87225738, 87225742, 4, 1366x768 
0x10EAE998, 38049091596029136, 87225807, 87225810, 3, 1366x768 
0x10EAE998, 38049091596697216, 87225871, 87225874, 3, 1366x768 
0x10EAE998, 38049091597371544, 87225958, 87225961, 3, 1366x768 
0x10EAE998, 38049091598711344, 87226071, 87226075, 4, 1366x768 
0x10EAE998, 38049091604043688, 87226626, 87226629, 3, 1366x768 
0x10EAE998, 38049091609373072, 87227158, 87227162, 4, 1366x768 
0x10EAE998, 38049091614703408, 87227689, 87227693, 4, 1366x768 
0x10EAE998, 38049091620058552, 87228226, 87228230, 4, 1366x768 
0x10EAE998, 38049091625386592, 87228758, 87228762, 4, 1366x768 
0x10EAE998, 38049091630713768, 87229294, 87229298, 4, 1366x768 
0x10EAE998, 38049091636047128, 87229827, 87229831, 4, 1366x768 
0x10EAE998, 38049091641384456, 87230357, 87230360, 3, 1366x768 
0x10EAE998, 38049091646738392, 87230895, 87230899, 4, 1366x768 
0x10EAE998, 38049091652095208, 87231429, 87231433, 4, 1366x768 
0x10EAE998, 38049091657419792, 87231964, 87231967, 3, 1366x768 
0x10EAE998, 38049091662770160, 87232498, 87232502, 4, 1366x768 
0x10EAE998, 38049091668103016, 87233034, 87233037, 3, 1366x768 
0x10EAE998, 38049091673462752, 87233568, 87233571, 3, 1366x768 
0x10EAE998, 38049091678788320, 87234099, 87234102, 3, 1366x768 
0x10EAE998, 38049091684127840, 87234631, 87234634, 3, 1366x768 
0x10EAE998, 38049091689464520, 87235164, 87235167, 3, 1366x768 
0x10EAE998, 38049091694778264, 87235697, 87235701, 4, 1366x768 
0x10EAE998, 38049091700117976, 87236229, 87236233, 4, 1366x768 
0x10EAE998, 38049091705460960, 87236764, 87236767, 3, 1366x768 
0x10EAE998, 38049091708793768, 87237083, 87237086, 3, 1366x768 
0x10EAE998, 38049091709456304, 87237146, 87237149, 3, 1366x768 
0x10EAE998, 38049091710128480, 87237215, 87237219, 4, 1366x768 
0x10EAE998, 38049091710798768, 87237298, 87237302, 4, 1366x768 
0x10EAE998, 38049091712807328, 87237479, 87237483, 4, 1366x768 
0x10EAE998, 38049091713476488, 87237550, 87237554, 4, 1366x768 
0x10EAE998, 38049091716818880, 87237880, 87237884, 4, 1366x768 
0x10EAE998, 38049091717484816, 87237949, 87237953, 4, 1366x768 
0x10EAE998, 38049091718143560, 87238014, 87238018, 4, 1366x768 
0x10EAE998, 38049091718814152, 87238083, 87238087, 4, 1366x768 
0x10EAE998, 38049091719487936, 87238151, 87238155, 4, 1366x768 
0x10EAE998, 38049091720159344, 87238218, 87238222, 4, 1366x768 
0x10EAE998, 38049091720826424, 87238300, 87238304, 4, 1366x768 
0x10EAE998, 38049091721493032, 87238351, 87238355, 4, 1366x768 
0x10EAE998, 38049091722159832, 87238417, 87238421, 4, 1366x768 
0x10EAE998, 38049091722818464, 87238485, 87238489, 4, 1366x768 
0x10EAE998, 38049091723488688, 87238554, 87238556, 2, 1366x768 
0x10EAE998, 38049091724163048, 87238620, 87238623, 3, 1366x768 
0x10EAE998, 38049091724833408, 87238704, 87238707, 3, 1366x768 
0x10EAE998, 38049091728820800, 87239088, 87239092, 4, 1366x768 
0x10EAE998, 38049091729488960, 87239154, 87239160, 6, 1366x768 
0x10EAE998, 38049091730156792, 87239219, 87239222, 3, 1366x768 
0x10EAE998, 38049091730830088, 87239284, 87239288, 4, 1366x768 
0x10EAE998, 38049091731491176, 87239357, 87239360, 3, 1366x768 
0x10EAE998, 38049091732155704, 87239424, 87239428, 4, 1366x768 
0x10EAE998, 38049091732828760, 87239486, 87239489, 3, 1366x768 
0x10EAE998, 38049091733489832, 87239548, 87239552, 4, 1366x768 
0x10EAE998, 38049091734158072, 87239638, 87239642, 4, 1366x768 
0x10EAE998, 38049091736832688, 87239898, 87239902, 4, 1366x768 
0x10EAE998, 38049091737502408, 87239973, 87239976, 3, 1366x768 
0x10EAE998, 38049091738160808, 87240020, 87240028, 8, 1366x768 
0x10EAE998, 38049091738829056, 87240085, 87240090, 5, 1366x768 
0x10EAE998, 38049091739497896, 87240151, 87240155, 4, 1366x768 
0x10EAE998, 38049091740166656, 87240216, 87240219, 3, 1366x768 
0x10EAE998, 38049091741504056, 87240351, 87240355, 4, 1366x768 
0x10EAE998, 38049091742170576, 87240419, 87240423, 4, 1366x768 
0x10EAE998, 38049091742842888, 87240489, 87240493, 4, 1366x768 
0x10EAE998, 38049091748169744, 87241019, 87241022, 3, 1366x768 
0x10EAE998, 38049091752851424, 87241495, 87241499, 4, 1366x768 
0x10EAE998, 38049091753519584, 87241554, 87241558, 4, 1366x768 
0x10EAE998, 38049091754188224, 87241618, 87241621, 3, 1366x768 
0x10EAE998, 38049091754857424, 87241708, 87241711, 3, 1366x768 
0x10EAE998, 38049091757522952, 87241950, 87241953, 3, 1366x768 
0x10EAE998, 38049091758194488, 87242023, 87242027, 4, 1366x768 
0x10EAE998, 38049091758866824, 87242089, 87242093, 4, 1366x768 
0x10EAE998, 38049091761536288, 87242357, 87242361, 4, 1366x768 
0x10EAE998, 38049091762209936, 87242420, 87242424, 4, 1366x768 
0x10EAE998, 38049091762880968, 87242486, 87242490, 4, 1366x768 
0x10EAE998, 38049091763555544, 87242554, 87242558, 4, 1366x768 
0x10EAE998, 38049091764222288, 87242622, 87242625, 3, 1366x768 
0x10EAE998, 38049091764883968, 87242691, 87242694, 3, 1366x768 
0x10EAE998, 38049091765554256, 87242754, 87242758, 4, 1366x768 
0x10EAE998, 38049091766224808, 87242827, 87242830, 3, 1366x768 
0x10EAE998, 38049091766883768, 87242888, 87242891, 3, 1366x768 
0x10EAE998, 38049091767556096, 87242955, 87242959, 4, 1366x768 
0x10EAE998, 38049091768223768, 87243022, 87243026, 4, 1366x768 
0x10EAE998, 38049091768892544, 87243091, 87243095, 4, 1366x768 
0x10EAE998, 38049091769562544, 87243160, 87243163, 3, 1366x768 
0x10EAE998, 38049091770230928, 87243225, 87243229, 4, 1366x768 
0x10EAE998, 38049091770897832, 87243293, 87243297, 4, 1366x768 
0x10EAE998, 38049091771557520, 87243362, 87243366, 4, 1366x768 
0x10EAE998, 38049091772218792, 87243445, 87243449, 4, 1366x768 
0x10EAE998, 38049091777544104, 87243976, 87243979, 3, 1366x768 
0x10EAE998, 38049091782894040, 87244507, 87244511, 4, 1366x768 
0x10EAE998, 38049091788220344, 87245039, 87245043, 4, 1366x768 
0x10EAE998, 38049091793573776, 87245576, 87245579, 3, 1366x768 
0x10EAE998, 38049091798903240, 87246110, 87246114, 4, 1366x768 
0x10EAE998, 38049091804247648, 87246644, 87246647, 3, 1366x768 
0x10EAE998, 38049091807578768, 87246960, 87246964, 4, 1366x768 
0x10EAE998, 38049091812944120, 87247516, 87247519, 3, 1366x768 
0x10EAE998, 38049091818304112, 87248050, 87248053, 3, 1366x768 
0x10EAE998, 38049091823661448, 87248588, 87248592, 4, 1366x768 
0x10EAE998, 38049091828988496, 87249122, 87249126, 4, 1366x768 
0x10EAE998, 38049091834340128, 87249652, 87249656, 4, 1366x768 
0x10EAE998, 38049091839678744, 87250189, 87250193, 4, 1366x768 
0x10EAE998, 38049091845014464, 87250720, 87250723, 3, 1366x768 
0x10EAE998, 38049091850353272, 87251256, 87251260, 4, 1366x768 
0x10EAE998, 38049091855687720, 87251789, 87251792, 3, 1366x768 
0x10EAE998, 38049091859013704, 87252101, 87252104, 3, 1366x768 
0x10EAE998, 38049091859685792, 87252167, 87252170, 3, 1366x768 
0x10EAE998, 38049091860357920, 87252239, 87252243, 4, 1366x768 
0x10EAE998, 38049091861018072, 87252301, 87252305, 4, 1366x768 
0x10EAE998, 38049091861686448, 87252370, 87252374, 4, 1366x768 
0x10EAE998, 38049091862355112, 87252437, 87252440, 3, 1366x768 
0x10EAE998, 38049091863019192, 87252501, 87252505, 4, 1366x768 
0x10EAE998, 38049091863690976, 87252572, 87252576, 4, 1366x768 
0x10EAE998, 38049091864362624, 87252639, 87252643, 4, 1366x768 
0x10EAE998, 38049091865026720, 87252705, 87252709, 4, 1366x768 
0x10EAE998, 38049091865701416, 87252773, 87252776, 3, 1366x768 
0x10EAE998, 38049091866368536, 87252837, 87252840, 3, 1366x768 
0x10EAE998, 38049091867036176, 87252904, 87252907, 3, 1366x768 
0x10EAE998, 38049091867704344, 87252972, 87252975, 3, 1366x768 
0x10EAE998, 38049091868370168, 87253037, 87253040, 3, 1366x768 
0x10EAE998, 38049091869042416, 87253104, 87253108, 4, 1366x768 
0x10EAE998, 38049091869710408, 87253173, 87253177, 4, 1366x768 
0x10EAE998, 38049091870378680, 87253241, 87253245, 4, 1366x768 
0x10EAE998, 38049091871047176, 87253307, 87253310, 3, 1366x768 
0x10EAE998, 38049091871712472, 87253373, 87253377, 4, 1366x768 
0x10EAE998, 38049091872373760, 87253442, 87253445, 3, 1366x768 
0x10EAE998, 38049091873047648, 87253506, 87253510, 4, 1366x768 
0x10EAE998, 38049091873722096, 87253572, 87253576, 4, 1366x768 
0x10EAE998, 38049091874390256, 87253641, 87253644, 3, 1366x768 
0x10EAE998, 38049091875056592, 87253706, 87253711, 5, 1366x768 
0x10EAE998, 38049091875724432, 87253772, 87253775, 3, 1366x768 
0x10EAE998, 38049091876392936, 87253839, 87253842, 3, 1366x768 
0x10EAE998, 38049091877055640, 87253906, 87253909, 3, 1366x768 
0x10EAE998, 38049091877728432, 87253993, 87253997, 4, 1366x768 
0x10EAE998, 38049091883069440, 87254527, 87254531, 4, 1366x768 
0x10EAE998, 38049091888420960, 87255062, 87255066, 4, 1366x768 
0x10EAE998, 38049091891091408, 87255313, 87255316, 3, 1366x768 
0x10EAE998, 38049091891765232, 87255378, 87255381, 3, 1366x768 
0x10EAE998, 38049091892439648, 87255444, 87255448, 4, 1366x768 
0x10EAE998, 38049091893109440, 87255515, 87255519, 4, 1366x768 
0x10EAE998, 38049091893771808, 87255580, 87255583, 3, 1366x768 
0x10EAE998, 38049091894443176, 87255646, 87255650, 4, 1366x768 
0x10EAE998, 38049091895119096, 87255713, 87255716, 3, 1366x768 
0x10EAE998, 38049091895780072, 87255780, 87255784, 4, 1366x768 
0x10EAE998, 38049091896454544, 87255846, 87255849, 3, 1366x768 
0x10EAE998, 38049091897123912, 87255914, 87255917, 3, 1366x768 
0x10EAE998, 38049091897797304, 87256005, 87256008, 3, 1366x768 
0x10EAE998, 38049091899139872, 87256116, 87256119, 3, 1366x768 
0x10EAE998, 38049091899806664, 87256201, 87256204, 3, 1366x768 
0x10EAE998, 38049091902469104, 87256465, 87256469, 4, 1366x768 
0x10EAE998, 38049091903138968, 87256532, 87256536, 4, 1366x768 
0x10EAE998, 38049091908501416, 87257073, 87257077, 4, 1366x768 
0x10EAE998, 38049091913837584, 87257602, 87257606, 4, 1366x768 
0x10EAE998, 38049091919173880, 87258138, 87258141, 3, 1366x768 
0x10EAE998, 38049091924521176, 87258675, 87258679, 4, 1366x768 
0x10EAE998, 38049091929856424, 87259205, 87259208, 3, 1366x768 
0x10EAE998, 38049091935225104, 87259745, 87259749, 4, 1366x768 
0x10EAE998, 38049091936555840, 87259855, 87259860, 5, 1366x768 
0x10EAE998, 38049091937228248, 87259922, 87259926, 4, 1366x768 
0x10EAE998, 38049091937895080, 87259990, 87259994, 4, 1366x768 
0x10EAE998, 38049091938568912, 87260057, 87260062, 5, 1366x768 
0x10EAE998, 38049091939236912, 87260127, 87260131, 4, 1366x768 
0x10EAE998, 38049091939895280, 87260191, 87260193, 2, 1366x768 
0x10EAE998, 38049091940560792, 87260257, 87260260, 3, 1366x768 
0x10EAE998, 38049091941232424, 87260324, 87260328, 4, 1366x768 
0x10EAE998, 38049091941899024, 87260391, 87260394, 3, 1366x768 
0x10EAE998, 38049091942565728, 87260460, 87260464, 4, 1366x768 
0x10EAE998, 38049091943238408, 87260526, 87260529, 3, 1366x768 
0x10EAE998, 38049091943905400, 87260594, 87260597, 3, 1366x768 
0x10EAE998, 38049091944567552, 87260657, 87260660, 3, 1366x768 
0x10EAE998, 38049091945232568, 87260723, 87260727, 4, 1366x768 
0x10EAE998, 38049091945901544, 87260791, 87260795, 4, 1366x768 
0x10EAE998, 38049091946565168, 87260860, 87260863, 3, 1366x768 
0x10EAE998, 38049091947232128, 87260926, 87260930, 4, 1366x768 
0x10EAE998, 38049091947902344, 87260993, 87260997, 4, 1366x768 
0x10EAE998, 38049091948571288, 87261059, 87261063, 4, 1366x768 
0x10EAE998, 38049091949239888, 87261127, 87261131, 4, 1366x768 
0x10EAE998, 38049091949903160, 87261194, 87261198, 4, 1366x768 
0x10EAE998, 38049091950576640, 87261276, 87261280, 4, 1366x768 
0x10EAE998, 38049091955910008, 87261814, 87261817, 3, 1366x768 
0x10EAE998, 38049091961251648, 87262348, 87262351, 3, 1366x768 
0x10EAE998, 38049091966600544, 87262882, 87262886, 4, 1366x768 
0x10EAE998, 38049091971290088, 87263330, 87263333, 3, 1366x768 
0x10EAE998, 38049091971958328, 87263400, 87263404, 4, 1366x768 
0x10EAE998, 38049091972626528, 87263464, 87263467, 3, 1366x768 
0x10EAE998, 38049091973294424, 87263528, 87263531, 3, 1366x768 
0x10EAE998, 38049091973957384, 87263598, 87263601, 3, 1366x768 
0x10EAE998, 38049091974627168, 87263663, 87263667, 4, 1366x768 
0x10EAE998, 38049091975295016, 87263732, 87263735, 3, 1366x768 
0x10EAE998, 38049091975964584, 87263794, 87263798, 4, 1366x768 
0x10EAE998, 38049091976633032, 87263866, 87263869, 3, 1366x768 
0x10EAE998, 38049091977299264, 87263951, 87263955, 4, 1366x768 
0x10EAE998, 38049091977958248, 87264013, 87264017, 4, 1366x768 
0x10EAE998, 38049091980636312, 87264263, 87264267, 4, 1366x768 
0x10EAE998, 38049091981306696, 87264330, 87264334, 4, 1366x768 
0x10EAE998, 38049091981966960, 87264399, 87264402, 3, 1366x768 
0x10EAE998, 38049091982634368, 87264466, 87264469, 3, 1366x768 
0x10EAE998, 38049091983302456, 87264532, 87264535, 3, 1366x768 
0x10EAE998, 38049091983974656, 87264599, 87264602, 3, 1366x768 
0x10EAE998, 38049091984643440, 87264664, 87264668, 4, 1366x768 
0x10EAE998, 38049091985306448, 87264735, 87264739, 4, 1366x768 
0x10EAE998, 38049091985973272, 87264800, 87264806, 6, 1366x768 
0x10EAE998, 38049091986641072, 87264865, 87264868, 3, 1366x768 
0x10EAE998, 38049091987310144, 87264936, 87264939, 3, 1366x768 
0x10EAE998, 38049091987978240, 87265017, 87265021, 4, 1366x768 
0x10EAE998, 38049091993298880, 87265553, 87265556, 3, 1366x768 
0x10EAE998, 38049091998635192, 87266087, 87266091, 4, 1366x768 
0x10EAE998, 38049092001967960, 87266398, 87266402, 4, 1366x768 
0x10EAE998, 38049092002636464, 87266467, 87266471, 4, 1366x768 
0x10EAE998, 38049092003302432, 87266530, 87266534, 4, 1366x768 
0x10EAE998, 38049092003976312, 87266597, 87266601, 4, 1366x768 
0x10EAE998, 38049092004644024, 87266686, 87266690, 4, 1366x768 
0x10EAE998, 38049092005319712, 87266755, 87266758, 3, 1366x768 
0x10EAE998, 38049092009977224, 87267197, 87267201, 4, 1366x768 
0x10EAE998, 38049092010646176, 87267266, 87267270, 4, 1366x768 
0x10EAE998, 38049092011309672, 87267334, 87267338, 4, 1366x768 
0x10EAE998, 38049092011979136, 87267397, 87267401, 4, 1366x768 
0x10EAE998, 38049092012647792, 87267471, 87267475, 4, 1366x768 
0x10EAE998, 38049092013308392, 87267533, 87267536, 3, 1366x768 
0x10EAE998, 38049092013971944, 87267615, 87267618, 3, 1366x768 
0x10EAE998, 38049092014635696, 87267684, 87267687, 3, 1366x768 
0x10EAE998, 38049092019986760, 87268221, 87268225, 4, 1366x768 
0x10EAE998, 38049092025333728, 87268754, 87268758, 4, 1366x768 
0x10EAE998, 38049092030671592, 87269286, 87269289, 3, 1366x768 
0x10EAE998, 38049092036002760, 87269824, 87269828, 4, 1366x768 
0x10EAE998, 38049092041333928, 87270352, 87270356, 4, 1366x768 
0x10EAE998, 38049092046759384, 87270898, 87270902, 4, 1366x768 
0x10EAE998, 38049092052096296, 87271430, 87271434, 4, 1366x768 
0x10EAE998, 38049092057444744, 87271966, 87271970, 4, 1366x768 
0x10EAE998, 38049092062788200, 87272502, 87272506, 4, 1366x768 
0x10EAE998, 38049092068120272, 87273035, 87273039, 4, 1366x768 
0x10EAE998, 38049092073456472, 87273565, 87273568, 3, 1366x768 
0x10EAE998, 38049092078799240, 87274100, 87274103, 3, 1366x768 
0x10EAE998, 38049092084140232, 87274634, 87274637, 3, 1366x768 
0x10EAE998, 38049092089478024, 87275169, 87275173, 4, 1366x768 
0x10EAE998, 38049092094819880, 87275701, 87275704, 3, 1366x768 
0x10EAE998, 38049092100160872, 87276237, 87276241, 4, 1366x768 
0x10EAE998, 38049092105511200, 87276774, 87276778, 4, 1366x768 
0x10EAE998, 38049092110857152, 87277307, 87277311, 4, 1366x768 
0x10EAE998, 38049092116186448, 87277840, 87277843, 3, 1366x768 
0x10EAE998, 38049092121533944, 87278373, 87278376, 3, 1366x768 
0x10EAE998, 38049092126861624, 87278907, 87278911, 4, 1366x768 
0x10EAE998, 38049092132203712, 87279439, 87279442, 3, 1366x768 
0x10EAE998, 38049092137537320, 87279977, 87279981, 4, 1366x768 
0x10EAE998, 38049092142874776, 87280507, 87280510, 3, 1366x768 
0x10EAE998, 38049092148233256, 87281044, 87281048, 4, 1366x768 
0x10EAE998, 38049092153585688, 87281578, 87281582, 4, 1366x768 
0x10EAE998, 38049092158915056, 87282111, 87282115, 4, 1366x768 
0x10EAE998, 38049092164233208, 87282644, 87282647, 3, 1366x768 
0x10EAE998, 38049092169559296, 87283177, 87283181, 4, 1366x768 
0x10EAE998, 38049092174897352, 87283714, 87283718, 4, 1366x768 
0x10EAE998, 38049092180224200, 87284242, 87284246, 4, 1366x768 
0x10EAE998, 38049092185567560, 87284776, 87284780, 4, 1366x768 
0x10EAE998, 38049092188241608, 87285039, 87285043, 4, 1366x768 
0x10EAE998, 38049092188910024, 87285090, 87285094, 4, 1366x768 
0x10EAE998, 38049092189574032, 87285157, 87285160, 3, 1366x768 
0x10EAE998, 38049092190242280, 87285226, 87285230, 4, 1366x768 
0x10EAE998, 38049092190910376, 87285292, 87285295, 3, 1366x768 
0x10EAE998, 38049092191578400, 87285360, 87285363, 3, 1366x768 
0x10EAE998, 38049092192248016, 87285426, 87285430, 4, 1366x768 
0x10EAE998, 38049092192915312, 87285492, 87285496, 4, 1366x768 
0x10EAE998, 38049092193584232, 87285559, 87285563, 4, 1366x768 
0x10EAE998, 38049092194261352, 87285628, 87285632, 4, 1366x768 
0x10EAE998, 38049092194930184, 87285694, 87285698, 4, 1366x768 
0x10EAE998, 38049092195604136, 87285762, 87285766, 4, 1366x768 
0x10EAE998, 38049092196269536, 87285831, 87285836, 5, 1366x768 
0x10EAE998, 38049092196942384, 87285898, 87285902, 4, 1366x768 
0x10EAE998, 38049092197616104, 87285967, 87285971, 4, 1366x768 
0x10EAE998, 38049092198281648, 87286029, 87286033, 4, 1366x768 
0x10EAE998, 38049092198943960, 87286097, 87286100, 3, 1366x768 
0x10EAE998, 38049092199622304, 87286165, 87286168, 3, 1366x768 
0x10EAE998, 38049092200292040, 87286232, 87286236, 4, 1366x768 
0x10EAE998, 38049092200963432, 87286298, 87286301, 3, 1366x768 
0x10EAE998, 38049092201635472, 87286365, 87286368, 3, 1366x768 
0x10EAE998, 38049092202298256, 87286433, 87286437, 4, 1366x768 
0x10EAE998, 38049092202970664, 87286500, 87286503, 3, 1366x768 
0x10EAE998, 38049092203642464, 87286566, 87286571, 5, 1366x768 
0x10EAE998, 38049092204310872, 87286632, 87286635, 3, 1366x768 
0x10EAE998, 38049092204978592, 87286698, 87286702, 4, 1366x768 
0x10EAE998, 38049092205644496, 87286766, 87286771, 5, 1366x768 
0x10EAE998, 38049092206316720, 87286834, 87286838, 4, 1366x768 
0x10EAE998, 38049092206987440, 87286902, 87286905, 3, 1366x768 
0x10EAE998, 38049092207656784, 87286971, 87286974, 3, 1366x768 
0x10EAE998, 38049092208327536, 87287032, 87287035, 3, 1366x768 
0x10EAE998, 38049092209000904, 87287100, 87287104, 4, 1366x768 
0x10EAE998, 38049092209674096, 87287167, 87287171, 4, 1366x768 
0x10EAE998, 38049092210341888, 87287237, 87287241, 4, 1366x768 
0x10EAE998, 38049092211009592, 87287301, 87287304, 3, 1366x768 
0x10EAE998, 38049092211688952, 87287372, 87287375, 3, 1366x768 
0x10EAE998, 38049092212358232, 87287456, 87287460, 4, 1366x768 
0x10EAE998, 38049092215032616, 87287704, 87287708, 4, 1366x768 
0x10EAE998, 38049092215703936, 87287772, 87287777, 5, 1366x768 
0x10EAE998, 38049092216373656, 87287840, 87287843, 3, 1366x768 
0x10EAE998, 38049092217038240, 87287902, 87287905, 3, 1366x768 
0x10EAE998, 38049092217705120, 87287969, 87287972, 3, 1366x768 
0x10EAE998, 38049092218377368, 87288059, 87288063, 4, 1366x768 
0x10EAE998, 38049092223694976, 87288573, 87288576, 3, 1366x768 
0x10EAE998, 38049092224362824, 87288637, 87288641, 4, 1366x768 
0x10EAE998, 38049092225031096, 87288706, 87288709, 3, 1366x768 
0x10EAE998, 38049092225701472, 87288771, 87288775, 4, 1366x768 
0x10EAE998, 38049092226371256, 87288839, 87288842, 3, 1366x768 
0x10EAE998, 38049092227037904, 87288909, 87288913, 4, 1366x768 
0x10EAE998, 38049092227707704, 87288972, 87288976, 4, 1366x768 
0x10EAE998, 38049092228373200, 87289038, 87289041, 3, 1366x768 
0x10EAE998, 38049092229048936, 87289108, 87289112, 4, 1366x768 
0x10EAE998, 38049092229715072, 87289173, 87289177, 4, 1366x768 
0x10EAE998, 38049092230382472, 87289240, 87289243, 3, 1366x768 
0x10EAE998, 38049092231050152, 87289324, 87289328, 4, 1366x768 
0x10EAE998, 38049092235040328, 87289710, 87289714, 4, 1366x768 
0x10EAE998, 38049092235702168, 87289773, 87289777, 4, 1366x768 
0x10EAE998, 38049092236366800, 87289838, 87289841, 3, 1366x768 
0x10EAE998, 38049092237035792, 87289907, 87289911, 4, 1366x768 
0x10EAE998, 38049092242383712, 87290460, 87290464, 4, 1366x768 
0x10EAE998, 38049092247741680, 87290995, 87290998, 3, 1366x768 
0x10EAE998, 38049092251078568, 87291310, 87291314, 4, 1366x768 
0x10EAE998, 38049092254420632, 87291646, 87291650, 4, 1366x768 
0x10EAE998, 38049092255094792, 87291730, 87291734, 4, 1366x768 
0x10EAE998, 38049092255762864, 87291797, 87291800, 3, 1366x768 
0x10EAE998, 38049092256425272, 87291842, 87291846, 4, 1366x768 
0x10EAE998, 38049092257096768, 87291910, 87291913, 3, 1366x768 
0x10EAE998, 38049092257769000, 87291977, 87291981, 4, 1366x768 
0x10EAE998, 38049092258437552, 87292046, 87292050, 4, 1366x768 
0x10EAE998, 38049092259096976, 87292110, 87292113, 3, 1366x768 
0x10EAE998, 38049092259779696, 87292181, 87292185, 4, 1366x768 
0x10EAE998, 38049092260445224, 87292245, 87292248, 3, 1366x768 
0x10EAE998, 38049092261113768, 87292315, 87292318, 3, 1366x768 
0x10EAE998, 38049092261782424, 87292381, 87292385, 4, 1366x768 
0x10EAE998, 38049092262451976, 87292445, 87292448, 3, 1366x768 
0x10EAE998, 38049092263123336, 87292514, 87292518, 4, 1366x768 
0x10EAE998, 38049092263784736, 87292581, 87292584, 3, 1366x768 
0x10EAE998, 38049092264457840, 87292666, 87292670, 4, 1366x768 
0x10EAE998, 38049092265127224, 87292734, 87292738, 4, 1366x768 
0x10EAE998, 38049092270474896, 87293266, 87293269, 3, 1366x768 
0x10EAE998, 38049092275805936, 87293804, 87293807, 3, 1366x768 
0x10EAE998, 38049092281153352, 87294338, 87294342, 4, 1366x768 
0x10EAE998, 38049092286484968, 87294871, 87294875, 4, 1366x768 
0x10EAE998, 38049092291833312, 87295405, 87295408, 3, 1366x768 
0x10EAE998, 38049092297158640, 87295937, 87295940, 3, 1366x768 
0x10EAE998, 38049092302520664, 87296472, 87296476, 4, 1366x768 
0x10EAE998, 38049092307874056, 87297009, 87297013, 4, 1366x768 
0x10EAE998, 38049092313204248, 87297544, 87297547, 3, 1366x768 
0x10EAE998, 38049092313872504, 87297588, 87297592, 4, 1366x768 
0x10EAE998, 38049092314538824, 87297659, 87297663, 4, 1366x768 
0x10EAE998, 38049092315217136, 87297725, 87297729, 4, 1366x768 
0x10EAE998, 38049092315885784, 87297792, 87297795, 3, 1366x768 
0x10EAE998, 38049092316558640, 87297857, 87297860, 3, 1366x768 
0x10EAE998, 38049092317227248, 87297925, 87297929, 4, 1366x768 
0x10EAE998, 38049092317895568, 87297988, 87297992, 4, 1366x768 
0x10EAE998, 38049092318567696, 87298057, 87298060, 3, 1366x768 
0x10EAE998, 38049092319243064, 87298125, 87298128, 3, 1366x768 
0x10EAE998, 38049092319910816, 87298195, 87298198, 3, 1366x768 
0x10EAE998, 38049092320581552, 87298258, 87298261, 3, 1366x768 
0x10EAE998, 38049092321249760, 87298325, 87298328, 3, 1366x768 
0x10EAE998, 38049092321917288, 87298392, 87298396, 4, 1366x768 
0x10EAE998, 38049092322590816, 87298460, 87298464, 4, 1366x768 
0x10EAE998, 38049092323253568, 87298527, 87298531, 4, 1366x768 
0x10EAE998, 38049092323920648, 87298592, 87298596, 4, 1366x768 
0x10EAE998, 38049092324584344, 87298659, 87298663, 4, 1366x768 
0x10EAE998, 38049092325261384, 87298729, 87298733, 4, 1366x768 
0x10EAE998, 38049092325935112, 87298797, 87298801, 4, 1366x768 
0x10EAE998, 38049092326601480, 87298860, 87298863, 3, 1366x768 
0x10EAE998, 38049092327264792, 87298929, 87298933, 4, 1366x768 
0x10EAE998, 38049092327929104, 87298993, 87298996, 3, 1366x768 
0x10EAE998, 38049092328594856, 87299063, 87299067, 4, 1366x768 
0x10EAE998, 38049092329265688, 87299125, 87299128, 3, 1366x768 
0x10EAE998, 38049092329938496, 87299193, 87299197, 4, 1366x768 
0x10EAE998, 38049092330604008, 87299261, 87299265, 4, 1366x768 
0x10EAE998, 38049092331268664, 87299327, 87299331, 4, 1366x768 
0x10EAE998, 38049092331945152, 87299394, 87299398, 4, 1366x768 
0x10EAE998, 38049092332616608, 87299463, 87299467, 4, 1366x768 
0x10EAE998, 38049092333277168, 87299551, 87299554, 3, 1366x768 
0x10EAE998, 38049092333941208, 87299612, 87299616, 4, 1366x768 
0x10EAE998, 38049092337281096, 87299927, 87299931, 4, 1366x768 
0x10EAE998, 38049092337951304, 87299996, 87300000, 4, 1366x768 
0x10EAE998, 38049092338619960, 87300064, 87300068, 4, 1366x768 
0x10EAE998, 38049092339286184, 87300131, 87300136, 5, 1366x768 
0x10EAE998, 38049092339944584, 87300198, 87300202, 4, 1366x768 
0x10EAE998, 38049092340610328, 87300260, 87300263, 3, 1366x768 
0x10EAE998, 38049092341279504, 87300326, 87300329, 3, 1366x768 
0x10EAE998, 38049092341948248, 87300398, 87300402, 4, 1366x768 
0x10EAE998, 38049092342655296, 87300472, 87300475, 3, 1366x768 
0x10EAE998, 38049092343325736, 87300534, 87300538, 4, 1366x768 
0x10EAE998, 38049092343991152, 87300602, 87300606, 4, 1366x768 
0x10EAE998, 38049092344661888, 87300670, 87300674, 4, 1366x768 
0x10EAE998, 38049092345335136, 87300733, 87300738, 5, 1366x768 
0x10EAE998, 38049092346011072, 87300803, 87300807, 4, 1366x768 
0x10EAE998, 38049092346683752, 87300868, 87300872, 4, 1366x768 
0x10EAE998, 38049092347355456, 87300934, 87300938, 4, 1366x768 
0x10EAE998, 38049092348027488, 87301004, 87301008, 4, 1366x768 
0x10EAE998, 38049092348697536, 87301071, 87301075, 4, 1366x768 
0x10EAE998, 38049092349367648, 87301140, 87301143, 3, 1366x768 
0x10EAE998, 38049092350037776, 87301206, 87301209, 3, 1366x768 
0x10EAE998, 38049092350706264, 87301272, 87301275, 3, 1366x768 
0x10EAE998, 38049092351376832, 87301336, 87301340, 4, 1366x768 
0x10EAE998, 38049092352059552, 87301409, 87301413, 4, 1366x768 
0x10EAE998, 38049092352725736, 87301477, 87301481, 4, 1366x768 
0x10EAE998, 38049092353391792, 87301539, 87301543, 4, 1366x768 
0x10EAE998, 38049092354061992, 87301607, 87301610, 3, 1366x768 
0x10EAE998, 38049092354735968, 87301674, 87301677, 3, 1366x768 
0x10EAE998, 38049092355401088, 87301739, 87301743, 4, 1366x768 
0x10EAE998, 38049092356075808, 87301812, 87301815, 3, 1366x768 
0x10EAE998, 38049092356748960, 87301877, 87301883, 6, 1366x768 
0x10EAE998, 38049092357415224, 87301943, 87301947, 4, 1366x768 
0x10EAE998, 38049092358085768, 87302010, 87302013, 3, 1366x768 
0x10EAE998, 38049092358754992, 87302095, 87302098, 3, 1366x768 
0x10EAE998, 38049092359416792, 87302158, 87302161, 3, 1366x768 
0x10EAE998, 38049092360083896, 87302209, 87302212, 3, 1366x768 
0x10EAE998, 38049092360749624, 87302277, 87302281, 4, 1366x768 
0x10EAE998, 38049092361419744, 87302344, 87302348, 4, 1366x768 
0x10EAE998, 38049092362094752, 87302410, 87302414, 4, 1366x768 
0x10EAE998, 38049092362762728, 87302478, 87302481, 3, 1366x768 
0x10EAE998, 38049092363430424, 87302545, 87302548, 3, 1366x768 
0x10EAE998, 38049092364102800, 87302613, 87302616, 3, 1366x768 
0x10EAE998, 38049092364766440, 87302679, 87302682, 3, 1366x768 
0x10EAE998, 38049092365435392, 87302748, 87302752, 4, 1366x768 
0x10EAE998, 38049092366096512, 87302811, 87302815, 4, 1366x768 
0x10EAE998, 38049092366759888, 87302877, 87302881, 4, 1366x768 
0x10EAE998, 38049092367428688, 87302945, 87302949, 4, 1366x768 
0x10EAE998, 38049092368101128, 87303030, 87303033, 3, 1366x768 
0x10EAE998, 38049092368766840, 87303096, 87303100, 4, 1366x768 
0x10EAE998, 38049092374114864, 87303632, 87303636, 4, 1366x768 
0x10EAE998, 38049092379456152, 87304164, 87304167, 3, 1366x768 
0x10EAE998, 38049092384795536, 87304700, 87304704, 4, 1366x768 
0x10EAE998, 38049092390140224, 87305233, 87305237, 4, 1366x768 
0x10EAE998, 38049092395475200, 87305770, 87305773, 3, 1366x768 
0x10EAE998, 38049092398819784, 87306085, 87306090, 5, 1366x768 
0x10EAE998, 38049092399483424, 87306150, 87306154, 4, 1366x768 
0x10EAE998, 38049092400152400, 87306216, 87306221, 5, 1366x768 
0x10EAE998, 38049092400820792, 87306284, 87306289, 5, 1366x768 
0x10EAE998, 38049092401492056, 87306353, 87306357, 4, 1366x768 
0x10EAE998, 38049092402163080, 87306418, 87306421, 3, 1366x768 
0x10EAE998, 38049092402826232, 87306483, 87306488, 5, 1366x768 
0x10EAE998, 38049092403493192, 87306552, 87306556, 4, 1366x768 
0x10EAE998, 38049092404158608, 87306620, 87306623, 3, 1366x768 
0x10EAE998, 38049092404835200, 87306685, 87306689, 4, 1366x768 
0x10EAE998, 38049092405508568, 87306775, 87306779, 4, 1366x768 
0x10EAE998, 38049092406838552, 87306882, 87306887, 5, 1366x768 
0x10EAE998, 38049092407506056, 87306953, 87306957, 4, 1366x768 
0x10EAE998, 38049092408181152, 87307023, 87307027, 4, 1366x768 
0x10EAE998, 38049092408849520, 87307104, 87307108, 4, 1366x768 
0x10EAE998, 38049092414188528, 87307618, 87307622, 4, 1366x768 
0x10EAE998, 38049092414863320, 87307692, 87307695, 3, 1366x768 
0x10EAE998, 38049092415535160, 87307754, 87307758, 4, 1366x768 
0x10EAE998, 38049092416205416, 87307823, 87307827, 4, 1366x768 
0x10EAE998, 38049092416871368, 87307890, 87307894, 4, 1366x768 
0x10EAE998, 38049092417532712, 87307972, 87307976, 4, 1366x768 
0x10EAE998, 38049092418868704, 87308091, 87308095, 4, 1366x768 
0x10EAE998, 38049092419539264, 87308153, 87308157, 4, 1366x768 
0x10EAE998, 38049092420212776, 87308224, 87308228, 4, 1366x768 
0x10EAE998, 38049092420880376, 87308290, 87308294, 4, 1366x768 
0x10EAE998, 38049092421555472, 87308374, 87308378, 4, 1366x768 
0x10EAE998, 38049092422229144, 87308446, 87308450, 4, 1366x768 
0x10EAE998, 38049092427563352, 87308958, 87308962, 4, 1366x768 
0x10EAE998, 38049092432879808, 87309509, 87309513, 4, 1366x768 
0x10EAE998, 38049092438225528, 87310045, 87310049, 4, 1366x768 
0x10EAE998, 38049092438894056, 87310106, 87310110, 4, 1366x768 
0x10EAE998, 38049092439563024, 87310156, 87310160, 4, 1366x768 
0x10EAE998, 38049092440231520, 87310224, 87310228, 4, 1366x768 
0x10EAE998, 38049092440902872, 87310291, 87310295, 4, 1366x768 
0x10EAE998, 38049092441570752, 87310360, 87310364, 4, 1366x768 
0x10EAE998, 38049092442238552, 87310424, 87310427, 3, 1366x768 
0x10EAE998, 38049092442906864, 87310493, 87310497, 4, 1366x768 
0x10EAE998, 38049092443575416, 87310558, 87310562, 4, 1366x768 
0x10EAE998, 38049092444243264, 87310627, 87310631, 4, 1366x768 
0x10EAE998, 38049092444908688, 87310690, 87310694, 4, 1366x768 
0x10EAE998, 38049092445578392, 87310763, 87310768, 5, 1366x768 
0x10EAE998, 38049092446249184, 87310847, 87310851, 4, 1366x768 
0x10EAE998, 38049092446911928, 87310914, 87310917, 3, 1366x768 
0x10EAE998, 38049092452254024, 87311428, 87311432, 4, 1366x768 
0x10EAE998, 38049092452918224, 87311494, 87311497, 3, 1366x768 
0x10EAE998, 38049092453592888, 87311562, 87311566, 4, 1366x768 
0x10EAE998, 38049092454259104, 87311626, 87311630, 4, 1366x768 
0x10EAE998, 38049092454930592, 87311693, 87311696, 3, 1366x768 
0x10EAE998, 38049092455600360, 87311778, 87311782, 4, 1366x768 
0x10EAE998, 38049092460953288, 87312315, 87312319, 4, 1366x768 
0x10EAE998, 38049092466286104, 87312847, 87312850, 3, 1366x768 
0x10EAE998, 38049092471625984, 87313383, 87313387, 4, 1366x768 
0x10EAE998, 38049092476974120, 87313918, 87313922, 4, 1366x768 
0x10EAE998, 38049092482309128, 87314449, 87314453, 4, 1366x768 
0x10EAE998, 38049092483640360, 87314580, 87314584, 4, 1366x768 
0x10EAE998, 38049092484301656, 87314630, 87314634, 4, 1366x768 
0x10EAE998, 38049092484973296, 87314697, 87314701, 4, 1366x768 
0x10EAE998, 38049092485646896, 87314764, 87314768, 4, 1366x768 
0x10EAE998, 38049092486312784, 87314831, 87314835, 4, 1366x768 
0x10EAE998, 38049092489656104, 87315165, 87315168, 3, 1366x768 
0x10EAE998, 38049092490319016, 87315235, 87315238, 3, 1366x768 
0x10EAE998, 38049092490985616, 87315298, 87315301, 3, 1366x768 
0x10EAE998, 38049092491653680, 87315388, 87315391, 3, 1366x768 
0x10EAE998, 38049092494998696, 87315699, 87315702, 3, 1366x768 
0x10EAE998, 38049092495665352, 87315766, 87315770, 4, 1366x768 
0x10EAE998, 38049092496335416, 87315835, 87315838, 3, 1366x768 
0x10EAE998, 38049092497005608, 87315920, 87315924, 4, 1366x768 
0x10EAE998, 38049092502320536, 87316455, 87316459, 4, 1366x768 
0x10EAE998, 38049092507637040, 87316982, 87316986, 4, 1366x768 
0x10EAE998, 38049092512976896, 87317517, 87317521, 4, 1366x768 
0x10EAE998, 38049092518293888, 87318051, 87318054, 3, 1366x768 
0x10EAE998, 38049092523631904, 87318581, 87318585, 4, 1366x768 
0x10EAE998, 38049092528944768, 87319115, 87319119, 4, 1366x768 
0x10EAE998, 38049092534297952, 87319650, 87319653, 3, 1366x768 
0x10EAE998, 38049092539635056, 87320187, 87320191, 4, 1366x768 
0x10EAE998, 38049092543631312, 87320564, 87320568, 4, 1366x768 
0x10EAE998, 38049092544304680, 87320634, 87320638, 4, 1366x768 
0x10EAE998, 38049092544975080, 87320699, 87320703, 4, 1366x768 
0x10EAE998, 38049092545641016, 87320769, 87320772, 3, 1366x768 
0x10EAE998, 38049092546311384, 87320851, 87320854, 3, 1366x768 
0x10EAE998, 38049092546977656, 87320919, 87320922, 3, 1366x768 
0x10EAE998, 38049092548980608, 87321098, 87321102, 4, 1366x768 
0x10EAE998, 38049092549654992, 87321169, 87321172, 3, 1366x768 
0x10EAE998, 38049092550326032, 87321237, 87321242, 5, 1366x768 
0x10EAE998, 38049092550994352, 87321320, 87321324, 4, 1366x768 
0x10EAE998, 38049092553670048, 87321567, 87321571, 4, 1366x768 
0x10EAE998, 38049092554339368, 87321634, 87321638, 4, 1366x768 
0x10EAE998, 38049092555007384, 87321705, 87321709, 4, 1366x768 
0x10EAE998, 38049092555672976, 87321788, 87321792, 4, 1366x768 
0x10EAE998, 38049092557017168, 87321904, 87321908, 4, 1366x768 
0x10EAE998, 38049092562366200, 87322455, 87322459, 4, 1366x768 
0x10EAE998, 38049092567698600, 87322991, 87322995, 4, 1366x768 
0x10EAE998, 38049092573019832, 87323523, 87323527, 4, 1366x768 
0x10EAE998, 38049092578342664, 87324054, 87324057, 3, 1366x768 
0x10EAE998, 38049092583680376, 87324587, 87324590, 3, 1366x768 
0x10EAE998, 38049092589037952, 87325124, 87325127, 3, 1366x768 
0x10EAE998, 38049092594375584, 87325661, 87325665, 4, 1366x768 
0x10EAE998, 38049092599053696, 87326104, 87326108, 4, 1366x768 
0x10EAE998, 38049092599720896, 87326174, 87326178, 4, 1366x768 
0x10EAE998, 38049092600391528, 87326244, 87326248, 4, 1366x768 
0x10EAE998, 38049092601059688, 87326308, 87326311, 3, 1366x768 
0x10EAE998, 38049092601739584, 87326377, 87326380, 3, 1366x768 
0x10EAE998, 38049092602403416, 87326441, 87326445, 4, 1366x768 
0x10EAE998, 38049092603076480, 87326506, 87326510, 4, 1366x768 
0x10EAE998, 38049092603745800, 87326574, 87326578, 4, 1366x768 
0x10EAE998, 38049092604411408, 87326642, 87326646, 4, 1366x768 
0x10EAE998, 38049092605070584, 87326710, 87326714, 4, 1366x768 
0x10EAE998, 38049092605734848, 87326777, 87326780, 3, 1366x768 
0x10EAE998, 38049092606401712, 87326861, 87326864, 3, 1366x768 
0x10EAE998, 38049092607067008, 87326911, 87326915, 4, 1366x768 
0x10EAE998, 38049092607731792, 87326973, 87326976, 3, 1366x768 
0x10EAE998, 38049092608405608, 87327065, 87327069, 4, 1366x768 
0x10EAE998, 38049092609069848, 87327129, 87327132, 3, 1366x768 
0x10EAE998, 38049092610403680, 87327241, 87327245, 4, 1366x768 
0x10EAE998, 38049092611066848, 87327309, 87327312, 3, 1366x768 
0x10EAE998, 38049092611726104, 87327374, 87327378, 4, 1366x768 
0x10EAE998, 38049092612390824, 87327441, 87327444, 3, 1366x768 
0x10EAE998, 38049092613061416, 87327504, 87327508, 4, 1366x768 
0x10EAE998, 38049092613737024, 87327574, 87327578, 4, 1366x768 
0x10EAE998, 38049092614411400, 87327644, 87327647, 3, 1366x768 
0x10EAE998, 38049092615079416, 87327710, 87327713, 3, 1366x768 
0x10EAE998, 38049092615747040, 87327775, 87327778, 3, 1366x768 
0x10EAE998, 38049092616416616, 87327846, 87327849, 3, 1366x768 
0x10EAE998, 38049092617087384, 87327912, 87327916, 4, 1366x768 
0x10EAE998, 38049092617751440, 87327975, 87327979, 4, 1366x768 
0x10EAE998, 38049092618420072, 87328044, 87328048, 4, 1366x768 
0x10EAE998, 38049092619085648, 87328111, 87328115, 4, 1366x768 
0x10EAE998, 38049092619752480, 87328178, 87328183, 5, 1366x768 
0x10EAE998, 38049092620417800, 87328245, 87328249, 4, 1366x768 
0x10EAE998, 38049092621088328, 87328330, 87328334, 4, 1366x768 
0x10EAE998, 38049092621755736, 87328394, 87328397, 3, 1366x768 
0x10EAE998, 38049092627089120, 87328930, 87328933, 3, 1366x768 
0x10EAE998, 38049092632446496, 87329464, 87329468, 4, 1366x768 
0x10EAE998, 38049092637793608, 87330002, 87330006, 4, 1366x768 
0x10EAE998, 38049092643134512, 87330536, 87330539, 3, 1366x768 
0x10EAE998, 38049092648483440, 87331068, 87331072, 4, 1366x768 
0x10EAE998, 38049092653839688, 87331606, 87331610, 4, 1366x768 
0x10EAE998, 38049092659171960, 87332140, 87332143, 3, 1366x768 
0x10EAE998, 38049092664516368, 87332674, 87332678, 4, 1366x768 
0x10EAE998, 38049092669838304, 87333202, 87333206, 4, 1366x768 
0x10EAE998, 38049092675168168, 87333738, 87333742, 4, 1366x768 
0x10EAE998, 38049092680513328, 87334273, 87334277, 4, 1366x768 
0x10EAE998, 38049092685867488, 87334809, 87334812, 3, 1366x768 
0x10EAE998, 38049092691222592, 87335341, 87335344, 3, 1366x768 
0x10EAE998, 38049092696563648, 87335875, 87335879, 4, 1366x768 
0x10EAE998, 38049092701895128, 87336408, 87336412, 4, 1366x768 
0x10EAE998, 38049092707238408, 87336942, 87336946, 4, 1366x768 
0x10EAE998, 38049092712575920, 87337477, 87337481, 4, 1366x768 
0x10EAE998, 38049092717918728, 87338016, 87338020, 4, 1366x768 
0x10EAE998, 38049092723252488, 87338545, 87338549, 4, 1366x768 
0x10EAE998, 38049092728594072, 87339078, 87339082, 4, 1366x768 
0x10EAE998, 38049092733922840, 87339616, 87339619, 3, 1366x768 
0x10EAE998, 38049092739267728, 87340145, 87340148, 3, 1366x768 
0x10EAE998, 38049092744614936, 87340681, 87340684, 3, 1366x768 
0x10EAE998, 38049092747947576, 87341013, 87341017, 4, 1366x768 
0x10EAE998, 38049092748616384, 87341065, 87341069, 4, 1366x768 
0x10EAE998, 38049092749288416, 87341133, 87341136, 3, 1366x768 
0x10EAE998, 38049092749959552, 87341197, 87341200, 3, 1366x768 
0x10EAE998, 38049092750630000, 87341264, 87341268, 4, 1366x768 
0x10EAE998, 38049092751300360, 87341330, 87341334, 4, 1366x768 
0x10EAE998, 38049092751967288, 87341398, 87341401, 3, 1366x768 
0x10EAE998, 38049092752634360, 87341465, 87341469, 4, 1366x768 
0x10EAE998, 38049092753301160, 87341534, 87341538, 4, 1366x768 
0x10EAE998, 38049092753965344, 87341600, 87341604, 4, 1366x768 
0x10EAE998, 38049092754626936, 87341664, 87341667, 3, 1366x768 
0x10EAE998, 38049092755301144, 87341732, 87341736, 4, 1366x768 
0x10EAE998, 38049092755964824, 87341800, 87341804, 4, 1366x768 
0x10EAE998, 38049092756631312, 87341862, 87341865, 3, 1366x768 
0x10EAE998, 38049092757301608, 87341931, 87341935, 4, 1366x768 
0x10EAE998, 38049092757968152, 87341999, 87342003, 4, 1366x768 
0x10EAE998, 38049092758639912, 87342066, 87342069, 3, 1366x768 
0x10EAE998, 38049092759308936, 87342134, 87342138, 4, 1366x768 
0x10EAE998, 38049092759980752, 87342201, 87342205, 4, 1366x768 
0x10EAE998, 38049092760655568, 87342267, 87342271, 4, 1366x768 
0x10EAE998, 38049092761321552, 87342332, 87342336, 4, 1366x768 
0x10EAE998, 38049092761982448, 87342398, 87342402, 4, 1366x768 
0x10EAE998, 38049092762652280, 87342468, 87342471, 3, 1366x768 
0x10EAE998, 38049092763319720, 87342533, 87342537, 4, 1366x768 
0x10EAE998, 38049092763987880, 87342603, 87342606, 3, 1366x768 
0x10EAE998, 38049092764656184, 87342669, 87342672, 3, 1366x768 
0x10EAE998, 38049092765328608, 87342738, 87342741, 3, 1366x768 
0x10EAE998, 38049092766002696, 87342803, 87342807, 4, 1366x768 
0x10EAE998, 38049092766674496, 87342871, 87342875, 4, 1366x768 
0x10EAE998, 38049092767343464, 87342935, 87342939, 4, 1366x768 
0x10EAE998, 38049092768019808, 87343004, 87343008, 4, 1366x768 
0x10EAE998, 38049092768695632, 87343073, 87343077, 4, 1366x768 
0x10EAE998, 38049092769364944, 87343140, 87343143, 3, 1366x768 
0x10EAE998, 38049092770034024, 87343203, 87343207, 4, 1366x768 
0x10EAE998, 38049092770703672, 87343271, 87343275, 4, 1366x768 
0x10EAE998, 38049092771370760, 87343337, 87343341, 4, 1366x768 
0x10EAE998, 38049092772042552, 87343404, 87343407, 3, 1366x768 
0x10EAE998, 38049092772712400, 87343471, 87343475, 4, 1366x768 
0x10EAE998, 38049092773380872, 87343539, 87343543, 4, 1366x768 
0x10EAE998, 38049092774053984, 87343605, 87343609, 4, 1366x768 
0x10EAE998, 38049092774721368, 87343674, 87343677, 3, 1366x768 
0x10EAE998, 38049092775396144, 87343742, 87343746, 4, 1366x768 
0x10EAE998, 38049092776060928, 87343810, 87343815, 5, 1366x768 
0x10EAE998, 38049092776727928, 87343878, 87343882, 4, 1366x768 
0x10EAE998, 38049092777396240, 87343943, 87343947, 4, 1366x768 
0x10EAE998, 38049092778064512, 87344007, 87344010, 3, 1366x768 
0x10EAE998, 38049092778738408, 87344077, 87344080, 3, 1366x768 
0x10EAE998, 38049092779400784, 87344140, 87344143, 3, 1366x768 
0x10EAE998, 38049092780073008, 87344210, 87344214, 4, 1366x768 
0x10EAE998, 38049092780740800, 87344277, 87344281, 4, 1366x768 
0x10EAE998, 38049092781409320, 87344344, 87344347, 3, 1366x768 
0x10EAE998, 38049092782078992, 87344412, 87344416, 4, 1366x768 
0x10EAE998, 38049092782746040, 87344475, 87344479, 4, 1366x768 
0x10EAE998, 38049092783406360, 87344541, 87344544, 3, 1366x768 
0x10EAE998, 38049092784080216, 87344608, 87344612, 4, 1366x768 
0x10EAE998, 38049092784750912, 87344674, 87344678, 4, 1366x768 
0x10EAE998, 38049092785422312, 87344762, 87344766, 4, 1366x768 
0x10EAE998, 38049092789428704, 87345158, 87345162, 4, 1366x768 
0x10EAE998, 38049092790097000, 87345210, 87345213, 3, 1366x768 
0x10EAE998, 38049092790767376, 87345278, 87345282, 4, 1366x768 
0x10EAE998, 38049092791437136, 87345362, 87345366, 4, 1366x768 
0x10EAE998, 38049092794113400, 87345613, 87345617, 4, 1366x768 
0x10EAE998, 38049092794782784, 87345677, 87345681, 4, 1366x768 
0x10EAE998, 38049092795453616, 87345747, 87345750, 3, 1366x768 
0x10EAE998, 38049092796118408, 87345832, 87345836, 4, 1366x768 
0x10EAE998, 38049092796790336, 87345892, 87345895, 3, 1366x768 
0x10EAE998, 38049092797455408, 87345949, 87345953, 4, 1366x768 
0x10EAE998, 38049092798127000, 87346013, 87346017, 4, 1366x768 
0x10EAE998, 38049092798797712, 87346083, 87346087, 4, 1366x768 
0x10EAE998, 38049092799469408, 87346146, 87346150, 4, 1366x768 
0x10EAE998, 38049092800141960, 87346238, 87346241, 3, 1366x768 
0x10EAE998, 38049092800813344, 87346299, 87346302, 3, 1366x768 
0x10EAE998, 38049092801479904, 87346351, 87346354, 3, 1366x768 
0x10EAE998, 38049092802146224, 87346419, 87346423, 4, 1366x768 
0x10EAE998, 38049092802814920, 87346485, 87346488, 3, 1366x768 
0x10EAE998, 38049092803483344, 87346551, 87346555, 4, 1366x768 
0x10EAE998, 38049092804154768, 87346619, 87346623, 4, 1366x768 
0x10EAE998, 38049092804822968, 87346686, 87346689, 3, 1366x768 
0x10EAE998, 38049092805493408, 87346769, 87346773, 4, 1366x768 
0x10EAE998, 38049092806166432, 87346821, 87346825, 4, 1366x768 
0x10EAE998, 38049092806839776, 87346886, 87346889, 3, 1366x768 
0x10EAE998, 38049092807502296, 87346951, 87346955, 4, 1366x768 
0x10EAE998, 38049092808170472, 87347023, 87347027, 4, 1366x768 
0x10EAE998, 38049092808829040, 87347081, 87347088, 7, 1366x768 
0x10EAE998, 38049092809499464, 87347151, 87347154, 3, 1366x768 
0x10EAE998, 38049092810168320, 87347234, 87347238, 4, 1366x768 
0x10EAE998, 38049092810831272, 87347302, 87347306, 4, 1366x768 
0x10EAE998, 38049092811499328, 87347357, 87347361, 4, 1366x768 
0x10EAE998, 38049092812167448, 87347422, 87347426, 4, 1366x768 
0x10EAE998, 38049092812839144, 87347486, 87347489, 3, 1366x768 
0x10EAE998, 38049092813508176, 87347555, 87347558, 3, 1366x768 
0x10EAE998, 38049092814179016, 87347642, 87347646, 4, 1366x768 
0x10EAE998, 38049092814838960, 87347694, 87347698, 4, 1366x768 
0x10EAE998, 38049092820169024, 87348237, 87348241, 4, 1366x768 
0x10EAE998, 38049092825499208, 87348769, 87348773, 4, 1366x768 
0x10EAE998, 38049092830835248, 87349304, 87349308, 4, 1366x768 
0x10EAE998, 38049092836178600, 87349837, 87349840, 3, 1366x768 
0x10EAE998, 38049092841508704, 87350375, 87350379, 4, 1366x768 
0x10EAE998, 38049092846850640, 87350906, 87350910, 4, 1366x768 
0x10EAE998, 38049092852190312, 87351441, 87351445, 4, 1366x768 
0x10EAE998, 38049092857537528, 87351976, 87351980, 4, 1366x768 
0x10EAE998, 38049092862883088, 87352510, 87352513, 3, 1366x768 
0x10EAE998, 38049092868207888, 87353040, 87353044, 4, 1366x768 
0x10EAE998, 38049092873537904, 87353574, 87353578, 4, 1366x768 
0x10EAE998, 38049092874875720, 87353689, 87353692, 3, 1366x768 
0x10EAE998, 38049092875542416, 87353751, 87353754, 3, 1366x768 
0x10EAE998, 38049092876211832, 87353821, 87353824, 3, 1366x768 
0x10EAE998, 38049092876876800, 87353888, 87353891, 3, 1366x768 
0x10EAE998, 38049092877542368, 87353957, 87353961, 4, 1366x768 
0x10EAE998, 38049092878208880, 87354022, 87354025, 3, 1366x768 
0x10EAE998, 38049092878877112, 87354111, 87354115, 4, 1366x768 
0x10EAE998, 38049092881535600, 87354353, 87354357, 4, 1366x768 
0x10EAE998, 38049092882197384, 87354421, 87354424, 3, 1366x768 
0x10EAE998, 38049092882864408, 87354490, 87354494, 4, 1366x768 
0x10EAE998, 38049092883539144, 87354554, 87354558, 4, 1366x768 
0x10EAE998, 38049092884210080, 87354623, 87354627, 4, 1366x768 
0x10EAE998, 38049092884882712, 87354692, 87354695, 3, 1366x768 
0x10EAE998, 38049092885553816, 87354760, 87354763, 3, 1366x768 
0x10EAE998, 38049092886217168, 87354823, 87354827, 4, 1366x768 
0x10EAE998, 38049092886884056, 87354889, 87354893, 4, 1366x768 
0x10EAE998, 38049092887560104, 87354955, 87354959, 4, 1366x768 
0x10EAE998, 38049092888234360, 87355025, 87355028, 3, 1366x768 
0x10EAE998, 38049092888893648, 87355091, 87355095, 4, 1366x768 
0x10EAE998, 38049092889567312, 87355158, 87355162, 4, 1366x768 
0x10EAE998, 38049092890237928, 87355224, 87355227, 3, 1366x768 
0x10EAE998, 38049092890906232, 87355294, 87355298, 4, 1366x768 
0x10EAE998, 38049092891577384, 87355359, 87355363, 4, 1366x768 
0x10EAE998, 38049092892242816, 87355443, 87355447, 4, 1366x768 
0x10EAE998, 38049092892914520, 87355511, 87355515, 4, 1366x768 
0x10EAE998, 38049092898232656, 87356042, 87356046, 4, 1366x768 
0x10EAE998, 38049092903570312, 87356577, 87356580, 3, 1366x768 
0x10EAE998, 38049092909094280, 87357128, 87357131, 3, 1366x768 
0x10EAE998, 38049092914429256, 87357665, 87357668, 3, 1366x768 
0x10EAE998, 38049092919768040, 87358194, 87358198, 4, 1366x768 
0x10EAE998, 38049092925106624, 87358728, 87358732, 4, 1366x768 
0x10EAE998, 38049092930443192, 87359265, 87359268, 3, 1366x768 
0x10EAE998, 38049092935793208, 87359798, 87359801, 3, 1366x768 
0x10EAE998, 38049092941139408, 87360336, 87360339, 3, 1366x768 
0x10EAE998, 38049092946491568, 87360871, 87360875, 4, 1366x768 
0x10EAE998, 38049092951846000, 87361405, 87361408, 3, 1366x768 
0x10EAE998, 38049092957163944, 87361935, 87361939, 4, 1366x768 
0x10EAE998, 38049092962495176, 87362467, 87362470, 3, 1366x768 
0x10EAE998, 38049092967842880, 87363003, 87363007, 4, 1366x768 
0x10EAE998, 38049092973212160, 87363545, 87363548, 3, 1366x768 
0x10EAE998, 38049092978556384, 87364074, 87364078, 4, 1366x768 
0x10EAE998, 38049092983900192, 87364615, 87364619, 4, 1366x768 
0x10EAE998, 38049092989230488, 87365145, 87365149, 4, 1366x768 
0x10EAE998, 38049092994582912, 87365681, 87365684, 3, 1366x768 
0x10EAE998, 38049092999927520, 87366214, 87366218, 4, 1366x768 
0x10EAE998, 38049093005271024, 87366749, 87366752, 3, 1366x768 
0x10EAE998, 38049093007283544, 87366931, 87366934, 3, 1366x768 
0x10EAE998, 38049093012624616, 87367482, 87367485, 3, 1366x768 
0x10EAE998, 38049093017965920, 87368015, 87368018, 3, 1366x768 
0x10EAE998, 38049093023294608, 87368550, 87368554, 4, 1366x768 
0x10EAE998, 38049093028634336, 87369082, 87369085, 3, 1366x768 
0x10EAE998, 38049093033946272, 87369617, 87369621, 4, 1366x768 
0x10EAE998, 38049093039278776, 87370150, 87370154, 4, 1366x768 
0x10EAE998, 38049093044605704, 87370680, 87370684, 4, 1366x768 
0x10EAE998, 38049093049934856, 87371212, 87371216, 4, 1366x768 
0x10EAE998, 38049093055282360, 87371747, 87371750, 3, 1366x768 
0x10EAE998, 38049093060622192, 87372281, 87372285, 4, 1366x768 
0x10EAE998, 38049093065942440, 87372816, 87372820, 4, 1366x768 
0x10EAE998, 38049093071261424, 87373348, 87373351, 3, 1366x768 
0x10EAE998, 38049093076597944, 87373878, 87373882, 4, 1366x768 
0x10EAE998, 38049093081917600, 87374415, 87374418, 3, 1366x768 
0x10EAE998, 38049093087260528, 87374945, 87374948, 3, 1366x768 
0x10EAE998, 38049093092605136, 87375482, 87375486, 4, 1366x768 
0x10EAE998, 38049093097920936, 87376011, 87376015, 4, 1366x768 
0x10EAE998, 38049093103247120, 87376546, 87376550, 4, 1366x768 
0x10EAE998, 38049093108591160, 87377082, 87377086, 4, 1366x768 
0x10EAE998, 38049093113915304, 87377610, 87377614, 4, 1366x768 
0x10EAE998, 38049093119265784, 87378148, 87378152, 4, 1366x768 
0x10EAE998, 38049093124608688, 87378685, 87378688, 3, 1366x768 
0x10EAE998, 38049093129960896, 87379213, 87379216, 3, 1366x768 
0x10EAE998, 38049093135326624, 87379756, 87379759, 3, 1366x768 
0x10EAE998, 38049093140664896, 87380285, 87380289, 4, 1366x768 
0x10EAE998, 38049093142003168, 87380403, 87380407, 4, 1366x768 
0x10EAE998, 38049093142683208, 87380472, 87380476, 4, 1366x768 
0x10EAE998, 38049093143353648, 87380537, 87380541, 4, 1366x768 
0x10EAE998, 38049093144015552, 87380607, 87380611, 4, 1366x768 
0x10EAE998, 38049093144683888, 87380670, 87380673, 3, 1366x768 
0x10EAE998, 38049093145354880, 87380740, 87380743, 3, 1366x768 
0x10EAE998, 38049093146023536, 87380804, 87380808, 4, 1366x768 
0x10EAE998, 38049093146698232, 87380870, 87380873, 3, 1366x768 
0x10EAE998, 38049093147370400, 87380938, 87380941, 3, 1366x768 
0x10EAE998, 38049093148040776, 87381005, 87381008, 3, 1366x768 
0x10EAE998, 38049093148706752, 87381070, 87381074, 4, 1366x768 
0x10EAE998, 38049093149380216, 87381140, 87381143, 3, 1366x768 
0x10EAE998, 38049093150048976, 87381208, 87381212, 4, 1366x768 
0x10EAE998, 38049093150717944, 87381271, 87381274, 3, 1366x768 
0x10EAE998, 38049093151389192, 87381342, 87381346, 4, 1366x768 
0x10EAE998, 38049093152052824, 87381407, 87381411, 4, 1366x768 
0x10EAE998, 38049093152721592, 87381475, 87381479, 4, 1366x768 
0x10EAE998, 38049093153388440, 87381542, 87381546, 4, 1366x768 
0x10EAE998, 38049093154059408, 87381606, 87381610, 4, 1366x768 
0x10EAE998, 38049093154728760, 87381674, 87381677, 3, 1366x768 
0x10EAE998, 38049093155400224, 87381740, 87381744, 4, 1366x768 
0x10EAE998, 38049093156070480, 87381807, 87381811, 4, 1366x768 
0x10EAE998, 38049093156739288, 87381876, 87381880, 4, 1366x768 
0x10EAE998, 38049093157404432, 87381943, 87381947, 4, 1366x768 
0x10EAE998, 38049093158072368, 87382010, 87382014, 4, 1366x768 
0x10EAE998, 38049093158740256, 87382074, 87382077, 3, 1366x768 
0x10EAE998, 38049093159409768, 87382144, 87382148, 4, 1366x768 
0x10EAE998, 38049093160078264, 87382208, 87382211, 3, 1366x768 
0x10EAE998, 38049093160743320, 87382277, 87382280, 3, 1366x768 
0x10EAE998, 38049093161414488, 87382345, 87382349, 4, 1366x768 
0x10EAE998, 38049093162080952, 87382411, 87382415, 4, 1366x768 
0x10EAE998, 38049093162752768, 87382474, 87382478, 4, 1366x768 
0x10EAE998, 38049093163420760, 87382542, 87382545, 3, 1366x768 
0x10EAE998, 38049093164078720, 87382606, 87382610, 4, 1366x768 
0x10EAE998, 38049093164753656, 87382678, 87382682, 4, 1366x768 
0x10EAE998, 38049093165418104, 87382746, 87382750, 4, 1366x768 
0x10EAE998, 38049093166086624, 87382813, 87382816, 3, 1366x768 
0x10EAE998, 38049093166757952, 87382876, 87382879, 3, 1366x768 
0x10EAE998, 38049093167424128, 87382944, 87382948, 4, 1366x768 
0x10EAE998, 38049093168094920, 87383010, 87383013, 3, 1366x768 
0x10EAE998, 38049093168770480, 87383079, 87383083, 4, 1366x768 
0x10EAE998, 38049093169441592, 87383146, 87383150, 4, 1366x768 
0x10EAE998, 38049093170113688, 87383216, 87383220, 4, 1366x768 
0x10EAE998, 38049093170779712, 87383281, 87383283, 2, 1366x768 
0x10EAE998, 38049093171453968, 87383369, 87383372, 3, 1366x768 
0x10EAE998, 38049093176796632, 87383902, 87383905, 3, 1366x768 
0x10EAE998, 38049093182152448, 87384438, 87384442, 4, 1366x768 
0x10EAE998, 38049093187486048, 87384971, 87384975, 4, 1366x768 
0x10EAE998, 38049093192826160, 87385502, 87385505, 3, 1366x768 
0x10EAE998, 38049093198162360, 87386037, 87386041, 4, 1366x768 
0x10EAE998, 38049093203519056, 87386570, 87386574, 4, 1366x768 
0x10EAE998, 38049093208848912, 87387106, 87387110, 4, 1366x768 
0x10EAE998, 38049093214175800, 87387641, 87387646, 5, 1366x768 
0x10EAE998, 38049093219510880, 87388167, 87388170, 3, 1366x768 
0x10EAE998, 38049093224862856, 87388706, 87388710, 4, 1366x768 
0x10EAE998, 38049093230211040, 87389244, 87389248, 4, 1366x768 
0x10EAE998, 38049093235535112, 87389772, 87389776, 4, 1366x768 
0x10EAE998, 38049093240878624, 87390310, 87390314, 4, 1366x768 
0x10EAE998, 38049093246305528, 87390852, 87390854, 2, 1366x768 
0x10EAE998, 38049093251667040, 87391386, 87391390, 4, 1366x768 
0x10EAE998, 38049093257007608, 87391920, 87391924, 4, 1366x768 
0x10EAE998, 38049093262369536, 87392458, 87392461, 3, 1366x768 
0x10EAE998, 38049093267717608, 87392991, 87392995, 4, 1366x768 
0x10EAE998, 38049093273052592, 87393529, 87393532, 3, 1366x768 
0x10EAE998, 38049093278388280, 87394057, 87394061, 4, 1366x768 
0x10EAE998, 38049093283729144, 87394596, 87394600, 4, 1366x768 
0x10EAE998, 38049093289057544, 87395127, 87395131, 4, 1366x768 
0x10EAE998, 38049093294403080, 87395660, 87395664, 4, 1366x768 
0x10EAE998, 38049093299745104, 87396199, 87396202, 3, 1366x768 
0x10EAE998, 38049093305089824, 87396730, 87396734, 4, 1366x768 
0x10EAE998, 38049093310428752, 87397263, 87397266, 3, 1366x768 
0x10EAE998, 38049093313099984, 87397525, 87397529, 4, 1366x768 
0x10EAE998, 38049093313771664, 87397578, 87397583, 5, 1366x768 
0x10EAE998, 38049093314446904, 87397645, 87397648, 3, 1366x768 
0x10EAE998, 38049093315118240, 87397714, 87397717, 3, 1366x768 
0x10EAE998, 38049093315778424, 87397777, 87397780, 3, 1366x768 
0x10EAE998, 38049093316444960, 87397843, 87397846, 3, 1366x768 
0x10EAE998, 38049093317113216, 87397913, 87397916, 3, 1366x768 
0x10EAE998, 38049093317781256, 87397982, 87397986, 4, 1366x768 
0x10EAE998, 38049093318449568, 87398048, 87398051, 3, 1366x768 
0x10EAE998, 38049093319118520, 87398114, 87398118, 4, 1366x768 
0x10EAE998, 38049093319790224, 87398182, 87398186, 4, 1366x768 
0x10EAE998, 38049093320464584, 87398248, 87398251, 3, 1366x768 
0x10EAE998, 38049093321135216, 87398318, 87398321, 3, 1366x768 
0x10EAE998, 38049093321809144, 87398387, 87398390, 3, 1366x768 
0x10EAE998, 38049093322475256, 87398451, 87398454, 3, 1366x768 
0x10EAE998, 38049093323148304, 87398517, 87398521, 4, 1366x768 
0x10EAE998, 38049093323812480, 87398582, 87398586, 4, 1366x768 
0x10EAE998, 38049093324482680, 87398648, 87398652, 4, 1366x768 
0x10EAE998, 38049093329839072, 87399184, 87399188, 4, 1366x768 
0x10EAE998, 38049093330505152, 87399252, 87399256, 4, 1366x768 
0x10EAE998, 38049093331169872, 87399317, 87399321, 4, 1366x768 
0x10EAE998, 38049093331834656, 87399383, 87399386, 3, 1366x768 
0x10EAE998, 38049093337171472, 87399939, 87399943, 4, 1366x768 
0x10EAE998, 38049093342494216, 87400472, 87400476, 4, 1366x768 
0x10EAE998, 38049093347822144, 87401005, 87401009, 4, 1366x768 
0x10EAE998, 38049093353169728, 87401539, 87401543, 4, 1366x768 
0x10EAE998, 38049093358495360, 87402069, 87402073, 4, 1366x768 
0x10EAE998, 38049093363845376, 87402604, 87402608, 4, 1366x768 
0x10EAE998, 38049093369171776, 87403140, 87403143, 3, 1366x768 
0x10EAE998, 38049093374499704, 87403668, 87403672, 4, 1366x768 
0x10EAE998, 38049093379834456, 87404185, 87404188, 3, 1366x768 
0x10EAE998, 38049093380510432, 87404250, 87404254, 4, 1366x768 
0x10EAE998, 38049093381178592, 87404318, 87404322, 4, 1366x768 
0x10EAE998, 38049093381849104, 87404387, 87404390, 3, 1366x768 
0x10EAE998, 38049093387204808, 87404942, 87404945, 3, 1366x768 
0x10EAE998, 38049093392531272, 87405472, 87405476, 4, 1366x768 
0x10EAE998, 38049093397866864, 87406005, 87406008, 3, 1366x768 
0x10EAE998, 38049093399209880, 87406121, 87406124, 3, 1366x768 
0x10EAE998, 38049093399878056, 87406192, 87406196, 4, 1366x768 
0x10EAE998, 38049093400552088, 87406256, 87406259, 3, 1366x768 
0x10EAE998, 38049093401220912, 87406321, 87406325, 4, 1366x768 
0x10EAE998, 38049093401889976, 87406389, 87406392, 3, 1366x768 
0x10EAE998, 38049093402560192, 87406459, 87406463, 4, 1366x768 
0x10EAE998, 38049093403230672, 87406527, 87406530, 3, 1366x768 
0x10EAE998, 38049093403901912, 87406590, 87406594, 4, 1366x768 
0x10EAE998, 38049093404569832, 87406656, 87406660, 4, 1366x768 
0x10EAE998, 38049093405235752, 87406723, 87406726, 3, 1366x768 
0x10EAE998, 38049093405899304, 87406789, 87406793, 4, 1366x768 
0x10EAE998, 38049093406564832, 87406860, 87406863, 3, 1366x768 
0x10EAE998, 38049093407237248, 87406943, 87406946, 3, 1366x768 
0x10EAE998, 38049093412581768, 87407480, 87407484, 4, 1366x768 
0x10EAE998, 38049093417922112, 87408011, 87408014, 3, 1366x768 
0x10EAE998, 38049093423253992, 87408545, 87408548, 3, 1366x768 
0x10EAE998, 38049093428591504, 87409078, 87409081, 3, 1366x768 
0x10EAE998, 38049093433940888, 87409614, 87409618, 4, 1366x768 
0x10EAE998, 38049093439274360, 87410151, 87410154, 3, 1366x768 
0x10EAE998, 38049093444597920, 87410680, 87410684, 4, 1366x768 
0x10EAE998, 38049093449931416, 87411212, 87411216, 4, 1366x768 
0x10EAE998, 38049093455282048, 87411748, 87411751, 3, 1366x768 
0x10EAE998, 38049093460624920, 87412285, 87412288, 3, 1366x768 
0x10EAE998, 38049093463293392, 87412532, 87412536, 4, 1366x768 
0x10EAE998, 38049093463965792, 87412599, 87412603, 4, 1366x768 
0x10EAE998, 38049093464634776, 87412665, 87412668, 3, 1366x768 
0x10EAE998, 38049093465302976, 87412733, 87412736, 3, 1366x768 
0x10EAE998, 38049093465970416, 87412803, 87412806, 3, 1366x768 
0x10EAE998, 38049093466641808, 87412864, 87412868, 4, 1366x768 
0x10EAE998, 38049093467307408, 87412933, 87412936, 3, 1366x768 
0x10EAE998, 38049093467976568, 87413000, 87413003, 3, 1366x768 
0x10EAE998, 38049093468653096, 87413068, 87413071, 3, 1366x768 
0x10EAE998, 38049093469321056, 87413133, 87413137, 4, 1366x768 
0x10EAE998, 38049093469989512, 87413200, 87413203, 3, 1366x768 
0x10EAE998, 38049093470658832, 87413269, 87413273, 4, 1366x768 
0x10EAE998, 38049093471317984, 87413332, 87413336, 4, 1366x768 
0x10EAE998, 38049093471984176, 87413398, 87413401, 3, 1366x768 
0x10EAE998, 38049093472656624, 87413467, 87413470, 3, 1366x768 
0x10EAE998, 38049093473325744, 87413534, 87413538, 4, 1366x768 
0x10EAE998, 38049093473994720, 87413601, 87413604, 3, 1366x768 
0x10EAE998, 38049093474669024, 87413667, 87413671, 4, 1366x768 
0x10EAE998, 38049093475338128, 87413735, 87413739, 4, 1366x768 
0x10EAE998, 38049093476009336, 87413801, 87413804, 3, 1366x768 
0x10EAE998, 38049093476675104, 87413870, 87413874, 4, 1366x768 
0x10EAE998, 38049093477341696, 87413937, 87413941, 4, 1366x768 
0x10EAE998, 38049093478007368, 87414005, 87414008, 3, 1366x768 
0x10EAE998, 38049093478681616, 87414066, 87414070, 4, 1366x768 
0x10EAE998, 38049093479352328, 87414138, 87414142, 4, 1366x768 
0x10EAE998, 38049093480020960, 87414220, 87414224, 4, 1366x768 
0x10EAE998, 38049093485389440, 87414740, 87414744, 4, 1366x768 
0x10EAE998, 38049093486061664, 87414810, 87414813, 3, 1366x768 
0x10EAE998, 38049093486740464, 87414875, 87414878, 3, 1366x768 
0x10EAE998, 38049093487413352, 87414944, 87414947, 3, 1366x768 
0x10EAE998, 38049093488088560, 87415010, 87415014, 4, 1366x768 
0x10EAE998, 38049093488755304, 87415075, 87415078, 3, 1366x768 
0x10EAE998, 38049093489428248, 87415149, 87415153, 4, 1366x768 
0x10EAE998, 38049093490093832, 87415210, 87415214, 4, 1366x768 
0x10EAE998, 38049093490766376, 87415278, 87415282, 4, 1366x768 
0x10EAE998, 38049093491435272, 87415367, 87415371, 4, 1366x768 
0x10EAE998, 38049093496772576, 87415899, 87415903, 4, 1366x768 
0x10EAE998, 38049093502098272, 87416429, 87416433, 4, 1366x768 
0x10EAE998, 38049093502763616, 87416477, 87416481, 4, 1366x768 
0x10EAE998, 38049093503431592, 87416546, 87416549, 3, 1366x768 
0x10EAE998, 38049093504098192, 87416612, 87416616, 4, 1366x768 
0x10EAE998, 38049093504766360, 87416678, 87416682, 4, 1366x768 
0x10EAE998, 38049093505432456, 87416747, 87416750, 3, 1366x768 
0x10EAE998, 38049093506100008, 87416813, 87416816, 3, 1366x768 
0x10EAE998, 38049093506770648, 87416877, 87416881, 4, 1366x768 
0x10EAE998, 38049093507439352, 87416944, 87416948, 4, 1366x768 
0x10EAE998, 38049093508115576, 87417012, 87417015, 3, 1366x768 
0x10EAE998, 38049093508783392, 87417100, 87417104, 4, 1366x768 
0x10EAE998, 38049093509451976, 87417164, 87417168, 4, 1366x768 
0x10EAE998, 38049093512116232, 87417414, 87417417, 3, 1366x768 
0x10EAE998, 38049093512788736, 87417481, 87417485, 4, 1366x768 
0x10EAE998, 38049093513458952, 87417548, 87417553, 5, 1366x768 
0x10EAE998, 38049093514130832, 87417619, 87417624, 5, 1366x768 
0x10EAE998, 38049093519463184, 87418165, 87418168, 3, 1366x768 
0x10EAE998, 38049093524797552, 87418701, 87418705, 4, 1366x768 
0x10EAE998, 38049093530136256, 87419237, 87419241, 4, 1366x768 
0x10EAE998, 38049093532794488, 87419487, 87419491, 4, 1366x768 
0x10EAE998, 38049093533460536, 87419550, 87419553, 3, 1366x768 
0x10EAE998, 38049093534430040, 87419658, 87419663, 5, 1366x768 
0x10EAE998, 38049093535090896, 87419712, 87419716, 4, 1366x768 
0x10EAE998, 38049093535758656, 87419780, 87419783, 3, 1366x768 
0x10EAE998, 38049093536429432, 87419844, 87419847, 3, 1366x768 
0x10EAE998, 38049093537097608, 87419910, 87419913, 3, 1366x768 
0x10EAE998, 38049093537765552, 87419978, 87419981, 3, 1366x768 
0x10EAE998, 38049093538432584, 87420042, 87420046, 4, 1366x768 
0x10EAE998, 38049093539100720, 87420109, 87420113, 4, 1366x768 
0x10EAE998, 38049093539767424, 87420181, 87420184, 3, 1366x768 
0x10EAE998, 38049093540437336, 87420250, 87420254, 4, 1366x768 
0x10EAE998, 38049093541105520, 87420314, 87420317, 3, 1366x768 
0x10EAE998, 38049093541777080, 87420376, 87420380, 4, 1366x768 
0x10EAE998, 38049093542446424, 87420449, 87420453, 4, 1366x768 
0x10EAE998, 38049093543114592, 87420514, 87420516, 2, 1366x768 
0x10EAE998, 38049093543783192, 87420583, 87420587, 4, 1366x768 
0x10EAE998, 38049093544449376, 87420653, 87420657, 4, 1366x768 
0x10EAE998, 38049093545117576, 87420712, 87420715, 3, 1366x768 
0x10EAE998, 38049093545785792, 87420783, 87420786, 3, 1366x768 
0x10EAE998, 38049093546452384, 87420871, 87420875, 4, 1366x768 
0x10EAE998, 38049093547790648, 87420981, 87420985, 4, 1366x768 
0x10EAE998, 38049093548458336, 87421064, 87421068, 4, 1366x768 
0x10EAE998, 38049093549118136, 87421117, 87421120, 3, 1366x768 
0x10EAE998, 38049093549784976, 87421182, 87421187, 5, 1366x768 
0x10EAE998, 38049093550448848, 87421254, 87421258, 4, 1366x768 
0x10EAE998, 38049093551116016, 87421314, 87421317, 3, 1366x768 
0x10EAE998, 38049093551784912, 87421378, 87421381, 3, 1366x768 
0x10EAE998, 38049093552453448, 87421443, 87421447, 4, 1366x768 
0x10EAE998, 38049093553124656, 87421512, 87421516, 4, 1366x768 
0x10EAE998, 38049093553797368, 87421583, 87421586, 3, 1366x768 
0x10EAE998, 38049093554466056, 87421649, 87421653, 4, 1366x768 
0x10EAE998, 38049093555125064, 87421712, 87421715, 3, 1366x768 
0x10EAE998, 38049093555794088, 87421782, 87421786, 4, 1366x768 
0x10EAE998, 38049093556456552, 87421847, 87421851, 4, 1366x768 
0x10EAE998, 38049093557126464, 87421931, 87421935, 4, 1366x768 
0x10EAE998, 38049093557789784, 87421998, 87422002, 4, 1366x768 
0x10EAE998, 38049093559793600, 87422185, 87422188, 3, 1366x768 
0x10EAE998, 38049093560466256, 87422249, 87422252, 3, 1366x768 
0x10EAE998, 38049093561136192, 87422316, 87422320, 4, 1366x768 
0x10EAE998, 38049093561796256, 87422399, 87422402, 3, 1366x768 
0x10EAE998, 38049093562458976, 87422447, 87422451, 4, 1366x768 
0x10EAE998, 38049093563124712, 87422513, 87422517, 4, 1366x768 
0x10EAE998, 38049093563791192, 87422581, 87422585, 4, 1366x768 
0x10EAE998, 38049093564463640, 87422666, 87422670, 4, 1366x768 
0x10EAE998, 38049093565124936, 87422733, 87422736, 3, 1366x768 
0x10EAE998, 38049093565792752, 87422783, 87422786, 3, 1366x768 
0x10EAE998, 38049093566462808, 87422847, 87422851, 4, 1366x768 
0x10EAE998, 38049093567123592, 87422915, 87422918, 3, 1366x768 
0x10EAE998, 38049093567799248, 87422980, 87422984, 4, 1366x768 
0x10EAE998, 38049093568457136, 87423068, 87423072, 4, 1366x768 
0x10EAE998, 38049093570457272, 87423251, 87423255, 4, 1366x768 
0x10EAE998, 38049093571115960, 87423317, 87423320, 3, 1366x768 
0x10EAE998, 38049093571777896, 87423378, 87423382, 4, 1366x768 
0x10EAE998, 38049093572446656, 87423446, 87423449, 3, 1366x768 
0x10EAE998, 38049093573111488, 87423509, 87423513, 4, 1366x768 
0x10EAE998, 38049093573784720, 87423580, 87423583, 3, 1366x768 
0x10EAE998, 38049093574457520, 87423651, 87423655, 4, 1366x768 
0x10EAE998, 38049093575125704, 87423715, 87423719, 4, 1366x768 
0x10EAE998, 38049093575794112, 87423780, 87423783, 3, 1366x768 
0x10EAE998, 38049093576462400, 87423844, 87423847, 3, 1366x768 
0x10EAE998, 38049093577130856, 87423916, 87423919, 3, 1366x768 
0x10EAE998, 38049093577798528, 87423981, 87423985, 4, 1366x768 
0x10EAE998, 38049093578462296, 87424048, 87424052, 4, 1366x768 
0x10EAE998, 38049093579124688, 87424114, 87424119, 5, 1366x768 
0x10EAE998, 38049093579795728, 87424180, 87424184, 4, 1366x768 
0x10EAE998, 38049093580462480, 87424248, 87424252, 4, 1366x768 
0x10EAE998, 38049093581132752, 87424315, 87424319, 4, 1366x768 
0x10EAE998, 38049093581807832, 87424400, 87424403, 3, 1366x768 
0x10EAE998, 38049093583807960, 87424582, 87424586, 4, 1366x768 
0x10EAE998, 38049093584477440, 87424651, 87424654, 3, 1366x768 
0x10EAE998, 38049093585138408, 87424717, 87424721, 4, 1366x768 
0x10EAE998, 38049093585807408, 87424784, 87424787, 3, 1366x768 
0x10EAE998, 38049093586467536, 87424851, 87424854, 3, 1366x768 
0x10EAE998, 38049093587131504, 87424916, 87424919, 3, 1366x768 
0x10EAE998, 38049093587804584, 87425000, 87425004, 4, 1366x768 
0x10EAE998, 38049093588476344, 87425068, 87425071, 3, 1366x768 
0x10EAE998, 38049093589143112, 87425114, 87425118, 4, 1366x768 
0x10EAE998, 38049093589815664, 87425189, 87425192, 3, 1366x768 
0x10EAE998, 38049093590485856, 87425251, 87425255, 4, 1366x768 
0x10EAE998, 38049093591160288, 87425320, 87425324, 4, 1366x768 
0x10EAE998, 38049093591826248, 87425385, 87425388, 3, 1366x768 
0x10EAE998, 38049093592491224, 87425456, 87425460, 4, 1366x768 
0x10EAE998, 38049093593159424, 87425520, 87425524, 4, 1366x768 
0x10EAE998, 38049093593828120, 87425586, 87425589, 3, 1366x768 
0x10EAE998, 38049093594765360, 87425712, 87425717, 5, 1366x768 
0x10EAE998, 38049093595433408, 87425743, 87425747, 4, 1366x768 
0x10EAE998, 38049093600109856, 87426213, 87426216, 3, 1366x768 
0x10EAE998, 38049093600777912, 87426278, 87426283, 5, 1366x768 
0x10EAE998, 38049093601445976, 87426349, 87426353, 4, 1366x768 
0x10EAE998, 38049093602114160, 87426414, 87426417, 3, 1366x768 
0x10EAE998, 38049093602783112, 87426479, 87426482, 3, 1366x768 
0x10EAE998, 38049093603451192, 87426545, 87426548, 3, 1366x768 
0x10EAE998, 38049093604120600, 87426632, 87426636, 4, 1366x768 
0x10EAE998, 38049093606771064, 87426881, 87426885, 4, 1366x768 
0x10EAE998, 38049093607439296, 87426947, 87426950, 3, 1366x768 
0x10EAE998, 38049093608107472, 87427013, 87427017, 4, 1366x768 
0x10EAE998, 38049093608773816, 87427078, 87427083, 5, 1366x768 
0x10EAE998, 38049093609441856, 87427144, 87427148, 4, 1366x768 
0x10EAE998, 38049093610110152, 87427212, 87427216, 4, 1366x768 
0x10EAE998, 38049093614098240, 87427612, 87427616, 4, 1366x768 
0x10EAE998, 38049093614767504, 87427677, 87427681, 4, 1366x768 
0x10EAE998, 38049093615435736, 87427747, 87427750, 3, 1366x768 
0x10EAE998, 38049093616103712, 87427816, 87427820, 4, 1366x768 
0x10EAE998, 38049093616772040, 87427881, 87427884, 3, 1366x768 
0x10EAE998, 38049093619445144, 87428145, 87428148, 3, 1366x768 
0x10EAE998, 38049093620113088, 87428211, 87428215, 4, 1366x768 
0x10EAE998, 38049093620781408, 87428278, 87428283, 5, 1366x768 
0x10EAE998, 38049093621449488, 87428343, 87428348, 5, 1366x768 
0x10EAE998, 38049093622121128, 87428415, 87428418, 3, 1366x768 
0x10EAE998, 38049093622784936, 87428478, 87428481, 3, 1366x768 
0x10EAE998, 38049093623453400, 87428544, 87428547, 3, 1366x768 
0x10EAE998, 38049093626133400, 87428820, 87428823, 3, 1366x768 
0x10EAE998, 38049093626801440, 87428889, 87428896, 7, 1366x768 
0x10EAE998, 38049093627469248, 87428948, 87428951, 3, 1366x768 
0x10EAE998, 38049093628137248, 87429018, 87429022, 4, 1366x768 
0x10EAE998, 38049093628800848, 87429083, 87429087, 4, 1366x768 
0x10EAE998, 38049093629469120, 87429149, 87429153, 4, 1366x768 
0x10EAE998, 38049093630132928, 87429220, 87429224, 4, 1366x768 
0x10EAE998, 38049093630801608, 87429281, 87429284, 3, 1366x768 
0x10EAE998, 38049093631469264, 87429353, 87429359, 6, 1366x768 
0x10EAE998, 38049093632137744, 87429438, 87429446, 8, 1366x768 
0x10EAE998, 38049093632806256, 87429486, 87429490, 4, 1366x768 
0x10EAE998, 38049093633473896, 87429551, 87429554, 3, 1366x768 
0x10EAE998, 38049093634810976, 87429681, 87429684, 3, 1366x768 
0x10EAE998, 38049093635469264, 87429753, 87429756, 3, 1366x768 
0x10EAE998, 38049093636147536, 87429818, 87429821, 3, 1366x768 
0x10EAE998, 38049093640822696, 87430283, 87430287, 4, 1366x768 
0x10EAE998, 38049093641491096, 87430349, 87430353, 4, 1366x768 
0x10EAE998, 38049093642159896, 87430418, 87430421, 3, 1366x768 
0x10EAE998, 38049093642830760, 87430484, 87430488, 4, 1366x768 
0x10EAE998, 38049093643495552, 87430555, 87430558, 3, 1366x768 
0x10EAE998, 38049093648830840, 87431105, 87431109, 4, 1366x768 
0x10EAE998, 38049093654169400, 87431637, 87431640, 3, 1366x768 
0x10EAE998, 38049093659492168, 87432168, 87432172, 4, 1366x768 
0x10EAE998, 38049093660162864, 87432231, 87432234, 3, 1366x768 
0x10EAE998, 38049093660835264, 87432290, 87432294, 4, 1366x768 
0x10EAE998, 38049093661503328, 87432349, 87432353, 4, 1366x768 
0x10EAE998, 38049093662169008, 87432419, 87432422, 3, 1366x768 
0x10EAE998, 38049093662845744, 87432487, 87432491, 4, 1366x768 
0x10EAE998, 38049093663513624, 87432552, 87432556, 4, 1366x768 
0x10EAE998, 38049093668878160, 87433109, 87433112, 3, 1366x768 
0x10EAE998, 38049093674229880, 87433645, 87433648, 3, 1366x768 
0x10EAE998, 38049093679556632, 87434178, 87434182, 4, 1366x768 
0x10EAE998, 38049093684893480, 87434713, 87434716, 3, 1366x768 
0x10EAE998, 38049093690225880, 87435244, 87435247, 3, 1366x768 
0x10EAE998, 38049093695565648, 87435777, 87435780, 3, 1366x768 
0x10EAE998, 38049093699567664, 87436157, 87436161, 4, 1366x768 
0x10EAE998, 38049093703569720, 87436561, 87436566, 5, 1366x768 
0x10EAE998, 38049093704237840, 87436627, 87436631, 4, 1366x768 
0x10EAE998, 38049093704906368, 87436693, 87436696, 3, 1366x768 
0x10EAE998, 38049093710244280, 87437225, 87437228, 3, 1366x768 
0x10EAE998, 38049093710914992, 87437294, 87437297, 3, 1366x768 
0x10EAE998, 38049093711580920, 87437362, 87437366, 4, 1366x768 
0x10EAE998, 38049093715598592, 87437765, 87437768, 3, 1366x768 
0x10EAE998, 38049093716269384, 87437829, 87437833, 4, 1366x768 
0x10EAE998, 38049093716935928, 87437896, 87437899, 3, 1366x768 
0x10EAE998, 38049093717604224, 87437962, 87437965, 3, 1366x768 
0x10EAE998, 38049093718270416, 87438030, 87438034, 4, 1366x768 
0x10EAE998, 38049093718934376, 87438113, 87438117, 4, 1366x768 
0x10EAE998, 38049093721610280, 87438363, 87438367, 4, 1366x768 
0x10EAE998, 38049093722278448, 87438432, 87438435, 3, 1366x768 
0x10EAE998, 38049093722948504, 87438494, 87438498, 4, 1366x768 
0x10EAE998, 38049093723619928, 87438562, 87438565, 3, 1366x768 
0x10EAE998, 38049093724287808, 87438633, 87438636, 3, 1366x768 
0x10EAE998, 38049093724956328, 87438697, 87438700, 3, 1366x768 
0x10EAE998, 38049093725624600, 87438766, 87438769, 3, 1366x768 
0x10EAE998, 38049093726291440, 87438848, 87438852, 4, 1366x768 
0x10EAE998, 38049093731637152, 87439382, 87439386, 4, 1366x768 
0x10EAE998, 38049093736968192, 87439919, 87439923, 4, 1366x768 
0x10EAE998, 38049093742302480, 87440448, 87440451, 3, 1366x768 
0x10EAE998, 38049093747629928, 87440981, 87440985, 4, 1366x768 
0x10EAE998, 38049093752965544, 87441517, 87441521, 4, 1366x768 
0x10EAE998, 38049093758289208, 87442049, 87442053, 4, 1366x768 
0x10EAE998, 38049093763616720, 87442583, 87442586, 3, 1366x768 
0x10EAE998, 38049093768935752, 87443115, 87443119, 4, 1366x768 
0x10EAE998, 38049093774286968, 87443649, 87443653, 4, 1366x768 
0x10EAE998, 38049093779640048, 87444185, 87444189, 4, 1366x768 
0x10EAE998, 38049093784954728, 87444714, 87444718, 4, 1366x768 
0x10EAE998, 38049093790290928, 87445249, 87445253, 4, 1366x768 
0x10EAE998, 38049093795629440, 87445785, 87445789, 4, 1366x768 
0x10EAE998, 38049093800973424, 87446318, 87446321, 3, 1366x768 
0x10EAE998, 38049093806320104, 87446852, 87446856, 4, 1366x768 
0x10EAE998, 38049093811659648, 87447386, 87447390, 4, 1366x768 
0x10EAE998, 38049093817008664, 87447922, 87447926, 4, 1366x768 
0x10EAE998, 38049093822352448, 87448457, 87448461, 4, 1366x768 
0x10EAE998, 38049093827690352, 87448994, 87448998, 4, 1366x768 
0x10EAE998, 38049093833020432, 87449525, 87449528, 3, 1366x768 
0x10EAE998, 38049093838343552, 87450056, 87450060, 4, 1366x768 
0x10EAE998, 38049093843687864, 87450591, 87450594, 3, 1366x768 
0x10EAE998, 38049093849035248, 87451123, 87451127, 4, 1366x768 
0x10EAE998, 38049093854388392, 87451657, 87451661, 4, 1366x768 
0x10EAE998, 38049093859734328, 87452192, 87452195, 3, 1366x768 
0x10EAE998, 38049093860399696, 87452248, 87452251, 3, 1366x768 
0x10EAE998, 38049093861068104, 87452310, 87452314, 4, 1366x768 
0x10EAE998, 38049093861736776, 87452373, 87452377, 4, 1366x768 
0x10EAE998, 38049093862410400, 87452445, 87452449, 4, 1366x768 
0x10EAE998, 38049093863078984, 87452508, 87452512, 4, 1366x768 
0x10EAE998, 38049093863751672, 87452576, 87452580, 4, 1366x768 
0x10EAE998, 38049093864421512, 87452645, 87452649, 4, 1366x768 
0x10EAE998, 38049093865085224, 87452708, 87452711, 3, 1366x768 
0x10EAE998, 38049093865753352, 87452773, 87452776, 3, 1366x768 
0x10EAE998, 38049093867089880, 87452910, 87452914, 4, 1366x768 
0x10EAE998, 38049093867757480, 87452976, 87452980, 4, 1366x768 
0x10EAE998, 38049093868425888, 87453044, 87453048, 4, 1366x768 
0x10EAE998, 38049093869096200, 87453110, 87453113, 3, 1366x768 
0x10EAE998, 38049093869756360, 87453177, 87453181, 4, 1366x768 
0x10EAE998, 38049093870428704, 87453260, 87453264, 4, 1366x768 
0x10EAE998, 38049093873147376, 87453519, 87453523, 4, 1366x768 
0x10EAE998, 38049093873821904, 87453586, 87453590, 4, 1366x768 
0x10EAE998, 38049093874496240, 87453651, 87453654, 3, 1366x768 
0x10EAE998, 38049093875161496, 87453719, 87453723, 4, 1366x768 
0x10EAE998, 38049093875834672, 87453785, 87453789, 4, 1366x768 
0x10EAE998, 38049093876505424, 87453854, 87453858, 4, 1366x768 
0x10EAE998, 38049093877173784, 87453916, 87453919, 3, 1366x768 
0x10EAE998, 38049093877841760, 87453988, 87453992, 4, 1366x768 
0x10EAE998, 38049093878511384, 87454059, 87454062, 3, 1366x768 
0x10EAE998, 38049093879179400, 87454118, 87454121, 3, 1366x768 
0x10EAE998, 38049093881184128, 87454321, 87454325, 4, 1366x768 
0x10EAE998, 38049093883858416, 87454589, 87454592, 3, 1366x768 
0x10EAE998, 38049093884527288, 87454673, 87454677, 4, 1366x768 
0x10EAE998, 38049093889877456, 87455207, 87455211, 4, 1366x768 
0x10EAE998, 38049093895206568, 87455744, 87455748, 4, 1366x768 
0x10EAE998, 38049093900547792, 87456273, 87456277, 4, 1366x768 
0x10EAE998, 38049093905890704, 87456808, 87456812, 4, 1366x768 
0x10EAE998, 38049093911230584, 87457346, 87457350, 4, 1366x768 
0x10EAE998, 38049093916574168, 87457879, 87457882, 3, 1366x768 
0x10EAE998, 38049093921909456, 87458410, 87458414, 4, 1366x768 
0x10EAE998, 38049093927247760, 87458947, 87458950, 3, 1366x768 
0x10EAE998, 38049093932584136, 87459477, 87459481, 4, 1366x768 
0x10EAE998, 38049093937926608, 87460014, 87460018, 4, 1366x768 
0x10EAE998, 38049093943270184, 87460548, 87460552, 4, 1366x768 
0x10EAE998, 38049093948605976, 87461080, 87461084, 4, 1366x768 
0x10EAE998, 38049093953951792, 87461614, 87461618, 4, 1366x768 
0x10EAE998, 38049093959304192, 87462152, 87462156, 4, 1366x768 
0x10EAE998, 38049093964671600, 87462689, 87462693, 4, 1366x768 
0x10EAE998, 38049093969999008, 87463221, 87463225, 4, 1366x768 
0x10EAE998, 38049093975331360, 87463758, 87463761, 3, 1366x768 
0x10EAE998, 38049093980662800, 87464284, 87464288, 4, 1366x768 
0x10EAE998, 38049093986019512, 87464825, 87464828, 3, 1366x768 
0x10EAE998, 38049093991354080, 87465357, 87465361, 4, 1366x768 
0x10EAE998, 38049093996677936, 87465887, 87465891, 4, 1366x768 
0x10EAE998, 38049094002018472, 87466423, 87466426, 3, 1366x768 
0x10EAE998, 38049094007355552, 87466954, 87466957, 3, 1366x768 
0x10EAE998, 38049094012699272, 87467493, 87467496, 3, 1366x768 
0x10EAE998, 38049094018039712, 87468024, 87468028, 4, 1366x768 
0x10EAE998, 38049094023388464, 87468558, 87468562, 4, 1366x768 
0x10EAE998, 38049094028730296, 87469091, 87469095, 4, 1366x768 
0x10EAE998, 38049094034084328, 87469631, 87469635, 4, 1366x768 
0x10EAE998, 38049094039433312, 87470167, 87470171, 4, 1366x768 
0x10EAE998, 38049094044765408, 87470697, 87470700, 3, 1366x768 
0x10EAE998, 38049094050081760, 87471228, 87471232, 4, 1366x768 
0x10EAE998, 38049094055423160, 87471759, 87471763, 4, 1366x768 
0x10EAE998, 38049094060749064, 87472296, 87472300, 4, 1366x768 
0x10EAE998, 38049094066110920, 87472831, 87472835, 4, 1366x768 
0x10EAE998, 38049094071459752, 87473369, 87473372, 3, 1366x768 
0x10EAE998, 38049094076803848, 87473898, 87473901, 3, 1366x768 
0x10EAE998, 38049094082150680, 87474436, 87474439, 3, 1366x768 
0x10EAE998, 38049094087507120, 87474973, 87474977, 4, 1366x768 
0x10EAE998, 38049094092853656, 87475505, 87475508, 3, 1366x768 
0x10EAE998, 38049094098199448, 87476039, 87476043, 4, 1366x768 
0x10EAE998, 38049094103539264, 87476575, 87476579, 4, 1366x768 
0x10EAE998, 38049094108897752, 87477111, 87477115, 4, 1366x768 
0x10EAE998, 38049094114226208, 87477640, 87477642, 2, 1366x768 
0x10EAE998, 38049094119580224, 87478178, 87478182, 4, 1366x768 
0x10EAE998, 38049094124915976, 87478713, 87478717, 4, 1366x768 
0x10EAE998, 38049094130259688, 87479247, 87479250, 3, 1366x768 
0x10EAE998, 38049094135602920, 87479780, 87479783, 3, 1366x768 
0x10EAE998, 38049094140950976, 87480319, 87480322, 3, 1366x768 
0x10EAE998, 38049094146284568, 87480847, 87480851, 4, 1366x768 
0x10EAE998, 38049094151625696, 87481385, 87481388, 3, 1366x768 
0x10EAE998, 38049094156955200, 87481914, 87481918, 4, 1366x768 
0x10EAE998, 38049094162290728, 87482448, 87482452, 4, 1366x768 
0x10EAE998, 38049094167633184, 87482984, 87482988, 4, 1366x768 
0x10EAE998, 38049094172961504, 87483516, 87483520, 4, 1366x768 
0x10EAE998, 38049094178304008, 87484049, 87484053, 4, 1366x768 
0x10EAE998, 38049094179631144, 87484163, 87484167, 4, 1366x768 
0x10EAE998, 38049094180295944, 87484230, 87484234, 4, 1366x768 
0x10EAE998, 38049094180959496, 87484300, 87484304, 4, 1366x768 
0x10EAE998, 38049094181622224, 87484366, 87484370, 4, 1366x768 
0x10EAE998, 38049094182290712, 87484431, 87484435, 4, 1366x768 
0x10EAE998, 38049094182958744, 87484502, 87484506, 4, 1366x768 
0x10EAE998, 38049094183627088, 87484565, 87484569, 4, 1366x768 
0x10EAE998, 38049094184295160, 87484630, 87484633, 3, 1366x768 
0x10EAE998, 38049094184967600, 87484697, 87484701, 4, 1366x768 
0x10EAE998, 38049094185638808, 87484763, 87484767, 4, 1366x768 
0x10EAE998, 38049094186314568, 87484831, 87484835, 4, 1366x768 
0x10EAE998, 38049094186987632, 87484905, 87484908, 3, 1366x768 
0x10EAE998, 38049094187657472, 87484965, 87484968, 3, 1366x768 
0x10EAE998, 38049094188324272, 87485033, 87485037, 4, 1366x768 
0x10EAE998, 38049094188994768, 87485100, 87485104, 4, 1366x768 
0x10EAE998, 38049094189661520, 87485168, 87485172, 4, 1366x768 
0x10EAE998, 38049094190319592, 87485237, 87485241, 4, 1366x768 
0x10EAE998, 38049094190992104, 87485303, 87485307, 4, 1366x768 
0x10EAE998, 38049094191657472, 87485368, 87485371, 3, 1366x768 
0x10EAE998, 38049094192326368, 87485436, 87485440, 4, 1366x768 
0x10EAE998, 38049094192997368, 87485503, 87485506, 3, 1366x768 
0x10EAE998, 38049094193669304, 87485570, 87485574, 4, 1366x768 
0x10EAE998, 38049094194336456, 87485633, 87485636, 3, 1366x768 
0x10EAE998, 38049094195007904, 87485701, 87485704, 3, 1366x768 
0x10EAE998, 38049094195677536, 87485770, 87485773, 3, 1366x768 
0x10EAE998, 38049094196347848, 87485836, 87485839, 3, 1366x768 
0x10EAE998, 38049094197015400, 87485905, 87485909, 4, 1366x768 
0x10EAE998, 38049094197683984, 87485971, 87485974, 3, 1366x768 
0x10EAE998, 38049094198347960, 87486037, 87486040, 3, 1366x768 
0x10EAE998, 38049094199016184, 87486103, 87486107, 4, 1366x768 
0x10EAE998, 38049094199689056, 87486173, 87486177, 4, 1366x768 
0x10EAE998, 38049094200356576, 87486240, 87486244, 4, 1366x768 
0x10EAE998, 38049094201024600, 87486304, 87486307, 3, 1366x768 
0x10EAE998, 38049094201697704, 87486374, 87486377, 3, 1366x768 
0x10EAE998, 38049094202367208, 87486437, 87486445, 8, 1366x768 
0x10EAE998, 38049094203038648, 87486504, 87486507, 3, 1366x768 
0x10EAE998, 38049094203714104, 87486571, 87486574, 3, 1366x768 
0x10EAE998, 38049094204391232, 87486643, 87486646, 3, 1366x768 
0x10EAE998, 38049094205060632, 87486706, 87486710, 4, 1366x768 
0x10EAE998, 38049094205718648, 87486772, 87486776, 4, 1366x768 
0x10EAE998, 38049094206389312, 87486845, 87486848, 3, 1366x768 
0x10EAE998, 38049094207060816, 87486907, 87486911, 4, 1366x768 
0x10EAE998, 38049094207728392, 87486975, 87486979, 4, 1366x768 
0x10EAE998, 38049094208394432, 87487041, 87487044, 3, 1366x768 
0x10EAE998, 38049094209063880, 87487106, 87487110, 4, 1366x768 
0x10EAE998, 38049094209737048, 87487175, 87487178, 3, 1366x768 
0x10EAE998, 38049094213733464, 87487577, 87487580, 3, 1366x768 
0x10EAE998, 38049094214401016, 87487641, 87487645, 4, 1366x768 
0x10EAE998, 38049094215070776, 87487709, 87487712, 3, 1366x768 
0x10EAE998, 38049094215731976, 87487774, 87487778, 4, 1366x768 
0x10EAE998, 38049094216406968, 87487843, 87487847, 4, 1366x768 
0x10EAE998, 38049094217071000, 87487909, 87487913, 4, 1366x768 
0x10EAE998, 38049094222387016, 87488461, 87488465, 4, 1366x768 
0x10EAE998, 38049094227710256, 87488993, 87488996, 3, 1366x768 
0x10EAE998, 38049094233061464, 87489529, 87489533, 4, 1366x768 
0x10EAE998, 38049094238392704, 87490062, 87490066, 4, 1366x768 
0x10EAE998, 38049094243726296, 87490592, 87490596, 4, 1366x768 
0x10EAE998, 38049094245723448, 87490786, 87490790, 4, 1366x768 
0x10EAE998, 38049094246382480, 87490837, 87490840, 3, 1366x768 
0x10EAE998, 38049094247051576, 87490908, 87490912, 4, 1366x768 
0x10EAE998, 38049094247722192, 87490974, 87490978, 4, 1366x768 
0x10EAE998, 38049094248387872, 87491043, 87491047, 4, 1366x768 
0x10EAE998, 38049094249062016, 87491109, 87491112, 3, 1366x768 
0x10EAE998, 38049094251079120, 87491311, 87491314, 3, 1366x768 
0x10EAE998, 38049094251739560, 87491396, 87491400, 4, 1366x768 
0x10EAE998, 38049094257080608, 87491931, 87491935, 4, 1366x768 
0x10EAE998, 38049094262430312, 87492467, 87492471, 4, 1366x768 
0x10EAE998, 38049094267785168, 87492981, 87492984, 3, 1366x768 
0x10EAE998, 38049094268453952, 87493045, 87493049, 4, 1366x768 
0x10EAE998, 38049094269121824, 87493112, 87493115, 3, 1366x768 
0x10EAE998, 38049094269796000, 87493184, 87493188, 4, 1366x768 
0x10EAE998, 38049094270462336, 87493250, 87493253, 3, 1366x768 
0x10EAE998, 38049094271132928, 87493316, 87493319, 3, 1366x768 
0x10EAE998, 38049094271807344, 87493379, 87493383, 4, 1366x768 
0x10EAE998, 38049094272478944, 87493451, 87493455, 4, 1366x768 
0x10EAE998, 38049094273154776, 87493515, 87493519, 4, 1366x768 
0x10EAE998, 38049094273822984, 87493584, 87493588, 4, 1366x768 
0x10EAE998, 38049094274493936, 87493647, 87493651, 4, 1366x768 
0x10EAE998, 38049094275164512, 87493719, 87493723, 4, 1366x768 
0x10EAE998, 38049094275829976, 87493785, 87493788, 3, 1366x768 
0x10EAE998, 38049094277166528, 87493918, 87493921, 3, 1366x768 
0x10EAE998, 38049094279171776, 87494117, 87494121, 4, 1366x768 
0x10EAE998, 38049094279842176, 87494190, 87494194, 4, 1366x768 
0x10EAE998, 38049094284515288, 87494670, 87494674, 4, 1366x768 
0x10EAE998, 38049094285183016, 87494723, 87494726, 3, 1366x768 
0x10EAE998, 38049094285845080, 87494783, 87494787, 4, 1366x768 
0x10EAE998, 38049094286513312, 87494854, 87494857, 3, 1366x768 
0x10EAE998, 38049094287176616, 87494918, 87494921, 3, 1366x768 
0x10EAE998, 38049094289849896, 87495188, 87495191, 3, 1366x768 
0x10EAE998, 38049094290519344, 87495253, 87495257, 4, 1366x768 
0x10EAE998, 38049094291186112, 87495321, 87495325, 4, 1366x768 
0x10EAE998, 38049094291854632, 87495386, 87495390, 4, 1366x768 
0x10EAE998, 38049094292526840, 87495453, 87495457, 4, 1366x768 
0x10EAE998, 38049094293858144, 87495587, 87495591, 4, 1366x768 
0x10EAE998, 38049094294531128, 87495657, 87495660, 3, 1366x768 
0x10EAE998, 38049094295196888, 87495720, 87495724, 4, 1366x768 
0x10EAE998, 38049094295866768, 87495791, 87495795, 4, 1366x768 
0x10EAE998, 38049094299195496, 87496122, 87496126, 4, 1366x768 
0x10EAE998, 38049094299862760, 87496188, 87496192, 4, 1366x768 
0x10EAE998, 38049094300532920, 87496254, 87496258, 4, 1366x768 
0x10EAE998, 38049094301205496, 87496342, 87496345, 3, 1366x768 
0x10EAE998, 38049094301873056, 87496387, 87496391, 4, 1366x768 
0x10EAE998, 38049094302541304, 87496454, 87496457, 3, 1366x768 
0x10EAE998, 38049094303200280, 87496525, 87496529, 4, 1366x768 
0x10EAE998, 38049094303871664, 87496592, 87496595, 3, 1366x768 
0x10EAE998, 38049094304529040, 87496673, 87496677, 4, 1366x768 
0x10EAE998, 38049094306538240, 87496858, 87496861, 3, 1366x768 
0x10EAE998, 38049094307204544, 87496925, 87496929, 4, 1366x768 
0x10EAE998, 38049094307871784, 87496995, 87496999, 4, 1366x768 
0x10EAE998, 38049094308536008, 87497055, 87497060, 5, 1366x768 
0x10EAE998, 38049094309194088, 87497121, 87497125, 4, 1366x768 
0x10EAE998, 38049094309861496, 87497192, 87497195, 3, 1366x768 
0x10EAE998, 38049094311849856, 87497406, 87497410, 4, 1366x768 
0x10EAE998, 38049094312540736, 87497460, 87497467, 7, 1366x768 
0x10EAE998, 38049094313205576, 87497525, 87497528, 3, 1366x768 
0x10EAE998, 38049094313878376, 87497595, 87497599, 4, 1366x768 
0x10EAE998, 38049094314551768, 87497660, 87497664, 4, 1366x768 
0x10EAE998, 38049094315218352, 87497731, 87497735, 4, 1366x768 
0x10EAE998, 38049094320570208, 87498257, 87498260, 3, 1366x768 
0x10EAE998, 38049094321903288, 87498393, 87498396, 3, 1366x768 
0x10EAE998, 38049094322569896, 87498460, 87498463, 3, 1366x768 
0x10EAE998, 38049094323236968, 87498530, 87498533, 3, 1366x768 
0x10EAE998, 38049094323907840, 87498593, 87498596, 3, 1366x768 
0x10EAE998, 38049094328581896, 87499059, 87499063, 4, 1366x768 
0x10EAE998, 38049094329250288, 87499129, 87499133, 4, 1366x768 
0x10EAE998, 38049094329915912, 87499194, 87499197, 3, 1366x768 
0x10EAE998, 38049094330584520, 87499258, 87499261, 3, 1366x768 
0x10EAE998, 38049094331248368, 87499345, 87499348, 3, 1366x768 
0x10EAE998, 38049094336604168, 87499879, 87499883, 4, 1366x768 
0x10EAE998, 38049094338612640, 87500065, 87500069, 4, 1366x768 
0x10EAE998, 38049094339958128, 87500198, 87500202, 4, 1366x768 
0x10EAE998, 38049094340617088, 87500266, 87500270, 4, 1366x768 
0x10EAE998, 38049094341285184, 87500329, 87500333, 4, 1366x768 
0x10EAE998, 38049094341948432, 87500398, 87500402, 4, 1366x768 
0x10EAE998, 38049094342617072, 87500463, 87500467, 4, 1366x768 
0x10EAE998, 38049094344622816, 87500664, 87500668, 4, 1366x768 
0x10EAE998, 38049094345290744, 87500734, 87500738, 4, 1366x768 
0x10EAE998, 38049094345963040, 87500797, 87500800, 3, 1366x768 
0x10EAE998, 38049094346635568, 87500863, 87500866, 3, 1366x768 
0x10EAE998, 38049094347970416, 87500998, 87501002, 4, 1366x768 
0x10EAE998, 38049094348644448, 87501066, 87501069, 3, 1366x768 
0x10EAE998, 38049094349313208, 87501131, 87501136, 5, 1366x768 
0x10EAE998, 38049094349980888, 87501202, 87501205, 3, 1366x768 
0x10EAE998, 38049094350649704, 87501267, 87501270, 3, 1366x768 
0x10EAE998, 38049094351318672, 87501336, 87501339, 3, 1366x768 
0x10EAE998, 38049094353993768, 87501616, 87501620, 4, 1366x768 
0x10EAE998, 38049094354663608, 87501669, 87501672, 3, 1366x768 
0x10EAE998, 38049094355326808, 87501733, 87501736, 3, 1366x768 
0x10EAE998, 38049094355994624, 87501803, 87501807, 4, 1366x768 
0x10EAE998, 38049094356662056, 87501872, 87501875, 3, 1366x768 
0x10EAE998, 38049094357336056, 87501934, 87501937, 3, 1366x768 
0x10EAE998, 38049094358009624, 87502002, 87502005, 3, 1366x768 
0x10EAE998, 38049094358684936, 87502072, 87502075, 3, 1366x768 
0x10EAE998, 38049094359350376, 87502136, 87502139, 3, 1366x768 
0x10EAE998, 38049094360018704, 87502204, 87502207, 3, 1366x768 
0x10EAE998, 38049094360685200, 87502271, 87502274, 3, 1366x768 
0x10EAE998, 38049094361359056, 87502339, 87502343, 4, 1366x768 
0x10EAE998, 38049094362032104, 87502405, 87502408, 3, 1366x768 
0x10EAE998, 38049094362703104, 87502491, 87502495, 4, 1366x768 
0x10EAE998, 38049094363365288, 87502537, 87502541, 4, 1366x768 
0x10EAE998, 38049094364031336, 87502607, 87502610, 3, 1366x768 
0x10EAE998, 38049094364689456, 87502671, 87502674, 3, 1366x768 
0x10EAE998, 38049094365357864, 87502740, 87502744, 4, 1366x768 
0x10EAE998, 38049094366026392, 87502806, 87502810, 4, 1366x768 
0x10EAE998, 38049094366693848, 87502874, 87502878, 4, 1366x768 
0x10EAE998, 38049094367363536, 87502937, 87502941, 4, 1366x768 
0x10EAE998, 38049094368030488, 87503005, 87503009, 4, 1366x768 
0x10EAE998, 38049094368698112, 87503074, 87503078, 4, 1366x768 
0x10EAE998, 38049094374036632, 87503623, 87503626, 3, 1366x768 
0x10EAE998, 38049094379384184, 87504157, 87504160, 3, 1366x768 
0x10EAE998, 38049094384733816, 87504694, 87504699, 5, 1366x768 
0x10EAE998, 38049094390074400, 87505207, 87505211, 4, 1366x768 
0x10EAE998, 38049094390750256, 87505278, 87505281, 3, 1366x768 
0x10EAE998, 38049094391421504, 87505344, 87505349, 5, 1366x768 
0x10EAE998, 38049094392084544, 87505412, 87505415, 3, 1366x768 
0x10EAE998, 38049094392757960, 87505474, 87505478, 4, 1366x768 
0x10EAE998, 38049094393423768, 87505541, 87505544, 3, 1366x768 
0x10EAE998, 38049094394092528, 87505627, 87505631, 4, 1366x768 
0x10EAE998, 38049094394759240, 87505680, 87505684, 4, 1366x768 
0x10EAE998, 38049094395426144, 87505743, 87505747, 4, 1366x768 
0x10EAE998, 38049094396091816, 87505814, 87505818, 4, 1366x768 
0x10EAE998, 38049094396769112, 87505880, 87505884, 4, 1366x768 
0x10EAE998, 38049094397434080, 87505963, 87505966, 3, 1366x768 
0x10EAE998, 38049094402770688, 87506499, 87506502, 3, 1366x768 
0x10EAE998, 38049094408103616, 87507030, 87507033, 3, 1366x768 
0x10EAE998, 38049094408771688, 87507080, 87507083, 3, 1366x768 
0x10EAE998, 38049094409441240, 87507148, 87507152, 4, 1366x768 
0x10EAE998, 38049094410106144, 87507230, 87507234, 4, 1366x768 
0x10EAE998, 38049094410770848, 87507279, 87507283, 4, 1366x768 
0x10EAE998, 38049094411439680, 87507363, 87507366, 3, 1366x768 
0x10EAE998, 38049094416759152, 87507899, 87507903, 4, 1366x768 
0x10EAE998, 38049094422096128, 87508428, 87508432, 4, 1366x768 
0x10EAE998, 38049094427422016, 87508961, 87508964, 3, 1366x768 
0x10EAE998, 38049094432770608, 87509499, 87509502, 3, 1366x768 
0x10EAE998, 38049094433437640, 87509544, 87509549, 5, 1366x768 
0x10EAE998, 38049094434106240, 87509614, 87509619, 5, 1366x768 
0x10EAE998, 38049094434774168, 87509679, 87509683, 4, 1366x768 
0x10EAE998, 38049094435443280, 87509744, 87509747, 3, 1366x768 
0x10EAE998, 38049094436113152, 87509815, 87509819, 4, 1366x768 
0x10EAE998, 38049094436783296, 87509879, 87509883, 4, 1366x768 
0x10EAE998, 38049094440136184, 87510220, 87510225, 5, 1366x768 
0x10EAE998, 38049094445508232, 87510771, 87510775, 4, 1366x768 
0x10EAE998, 38049094448861704, 87511090, 87511094, 4, 1366x768 
0x10EAE998, 38049094449546056, 87511163, 87511167, 4, 1366x768 
0x10EAE998, 38049094450218024, 87511223, 87511228, 5, 1366x768 
0x10EAE998, 38049094450875728, 87511289, 87511292, 3, 1366x768 
0x10EAE998, 38049094451546952, 87511361, 87511365, 4, 1366x768 
0x10EAE998, 38049094452222256, 87511427, 87511430, 3, 1366x768 
0x10EAE998, 38049094452890440, 87511493, 87511496, 3, 1366x768 
0x10EAE998, 38049094453557512, 87511559, 87511562, 3, 1366x768 
0x10EAE998, 38049094454229344, 87511622, 87511626, 4, 1366x768 
0x10EAE998, 38049094454897992, 87511692, 87511695, 3, 1366x768 
0x10EAE998, 38049094455563568, 87511771, 87511774, 3, 1366x768 
0x10EAE998, 38049094456233952, 87511822, 87511826, 4, 1366x768 
0x10EAE998, 38049094456898792, 87511890, 87511894, 4, 1366x768 
0x10EAE998, 38049094457574568, 87511957, 87511961, 4, 1366x768 
0x10EAE998, 38049094458241808, 87512049, 87512053, 4, 1366x768 
0x10EAE998, 38049094458903720, 87512101, 87512105, 4, 1366x768 
0x10EAE998, 38049094459573864, 87512156, 87512160, 4, 1366x768 
0x10EAE998, 38049094460241400, 87512226, 87512230, 4, 1366x768 
0x10EAE998, 38049094460910400, 87512294, 87512297, 3, 1366x768 
0x10EAE998, 38049094461574184, 87512356, 87512359, 3, 1366x768 
0x10EAE998, 38049094462238872, 87512425, 87512428, 3, 1366x768 
0x10EAE998, 38049094462906912, 87512489, 87512492, 3, 1366x768 
0x10EAE998, 38049094463577128, 87512561, 87512564, 3, 1366x768 
0x10EAE998, 38049094464243040, 87512623, 87512627, 4, 1366x768 
0x10EAE998, 38049094464911224, 87512696, 87512700, 4, 1366x768 
0x10EAE998, 38049094465579288, 87512757, 87512761, 4, 1366x768 
0x10EAE998, 38049094466247120, 87512826, 87512829, 3, 1366x768 
0x10EAE998, 38049094466915816, 87512896, 87512900, 4, 1366x768 
0x10EAE998, 38049094467584128, 87512960, 87512963, 3, 1366x768 
0x10EAE998, 38049094468251976, 87513027, 87513031, 4, 1366x768 
0x10EAE998, 38049094468920792, 87513111, 87513115, 4, 1366x768 
0x10EAE998, 38049094474251024, 87513646, 87513650, 4, 1366x768 
0x10EAE998, 38049094479592696, 87514178, 87514182, 4, 1366x768 
0x10EAE998, 38049094484930008, 87514715, 87514719, 4, 1366x768 
0x10EAE998, 38049094490266608, 87515248, 87515251, 3, 1366x768 
0x10EAE998, 38049094495600400, 87515780, 87515785, 5, 1366x768 
0x10EAE998, 38049094500942480, 87516314, 87516317, 3, 1366x768 
0x10EAE998, 38049094506272112, 87516848, 87516852, 4, 1366x768 
0x10EAE998, 38049094511601448, 87517379, 87517383, 4, 1366x768 
0x10EAE998, 38049094516945976, 87517917, 87517921, 4, 1366x768 
0x10EAE998, 38049094522272824, 87518450, 87518454, 4, 1366x768 
0x10EAE998, 38049094527616088, 87518980, 87518984, 4, 1366x768 
0x10EAE998, 38049094532958776, 87519516, 87519520, 4, 1366x768 
0x10EAE998, 38049094538305952, 87520053, 87520057, 4, 1366x768 
0x10EAE998, 38049094543622136, 87520581, 87520585, 4, 1366x768 
0x10EAE998, 38049094548955464, 87521116, 87521119, 3, 1366x768 
0x10EAE998, 38049094554297728, 87521649, 87521653, 4, 1366x768 
0x10EAE998, 38049094556958288, 87521898, 87521902, 4, 1366x768 
0x10EAE998, 38049094557625440, 87521962, 87521965, 3, 1366x768 
0x10EAE998, 38049094558297448, 87522030, 87522033, 3, 1366x768 
0x10EAE998, 38049094558961744, 87522099, 87522103, 4, 1366x768 
0x10EAE998, 38049094561637816, 87522371, 87522375, 4, 1366x768 
0x10EAE998, 38049094562305112, 87522432, 87522436, 4, 1366x768 
0x10EAE998, 38049094562964600, 87522497, 87522500, 3, 1366x768 
0x10EAE998, 38049094563625688, 87522563, 87522566, 3, 1366x768 
0x10EAE998, 38049094564287392, 87522633, 87522636, 3, 1366x768 
0x10EAE998, 38049094564957552, 87522716, 87522720, 4, 1366x768 
0x10EAE998, 38049094566290720, 87522833, 87522836, 3, 1366x768 
0x10EAE998, 38049094566963168, 87522897, 87522901, 4, 1366x768 
0x10EAE998, 38049094567631496, 87522967, 87522971, 4, 1366x768 
0x10EAE998, 38049094568299656, 87523033, 87523036, 3, 1366x768 
0x10EAE998, 38049094568967864, 87523098, 87523101, 3, 1366x768 
0x10EAE998, 38049094569626440, 87523164, 87523168, 4, 1366x768 
0x10EAE998, 38049094570296808, 87523237, 87523241, 4, 1366x768 
0x10EAE998, 38049094570969808, 87523304, 87523309, 5, 1366x768 
0x10EAE998, 38049094571632800, 87523368, 87523372, 4, 1366x768 
0x10EAE998, 38049094572296112, 87523434, 87523438, 4, 1366x768 
0x10EAE998, 38049094572979168, 87523500, 87523504, 4, 1366x768 
0x10EAE998, 38049094573647696, 87523568, 87523571, 3, 1366x768 
0x10EAE998, 38049094574316056, 87523634, 87523638, 4, 1366x768 
0x10EAE998, 38049094574980024, 87523705, 87523709, 4, 1366x768 
0x10EAE998, 38049094575645920, 87523766, 87523769, 3, 1366x768 
0x10EAE998, 38049094576319664, 87523836, 87523839, 3, 1366x768 
0x10EAE998, 38049094576988816, 87523899, 87523903, 4, 1366x768 
0x10EAE998, 38049094577657168, 87523984, 87523988, 4, 1366x768 
0x10EAE998, 38049094579660224, 87524166, 87524170, 4, 1366x768 
0x10EAE998, 38049094580331080, 87524233, 87524236, 3, 1366x768 
0x10EAE998, 38049094580993336, 87524302, 87524306, 4, 1366x768 
0x10EAE998, 38049094581652088, 87524372, 87524380, 8, 1366x768 
0x10EAE998, 38049094582345632, 87524439, 87524443, 4, 1366x768 
0x10EAE998, 38049094583017568, 87524505, 87524509, 4, 1366x768 
0x10EAE998, 38049094583685704, 87524573, 87524577, 4, 1366x768 
0x10EAE998, 38049094584356160, 87524638, 87524642, 4, 1366x768 
0x10EAE998, 38049094585022400, 87524704, 87524707, 3, 1366x768 
0x10EAE998, 38049094585690456, 87524769, 87524772, 3, 1366x768 
0x10EAE998, 38049094586354016, 87524839, 87524842, 3, 1366x768 
0x10EAE998, 38049094587022552, 87524926, 87524930, 4, 1366x768 
0x10EAE998, 38049094589023544, 87525107, 87525111, 4, 1366x768 
0x10EAE998, 38049094589691392, 87525176, 87525180, 4, 1366x768 
0x10EAE998, 38049094590359520, 87525240, 87525245, 5, 1366x768 
0x10EAE998, 38049094591191264, 87525338, 87525350, 12, 1366x768 
0x10EAE998, 38049094592174432, 87525431, 87525435, 4, 1366x768 
0x10EAE998, 38049094592843224, 87525490, 87525493, 3, 1366x768 
0x10EAE998, 38049094594170032, 87525621, 87525632, 11, 1366x768 
0x10EAE998, 38049094594839240, 87525687, 87525690, 3, 1366x768 
0x10EAE998, 38049094595507656, 87525751, 87525755, 4, 1366x768 
0x10EAE998, 38049094596176144, 87525819, 87525822, 3, 1366x768 
0x10EAE998, 38049094596841056, 87525904, 87525907, 3, 1366x768 
0x10EAE998, 38049094597510784, 87525970, 87525974, 4, 1366x768 
0x10EAE998, 38049094598172160, 87526020, 87526023, 3, 1366x768 
0x10EAE998, 38049094598841760, 87526084, 87526088, 4, 1366x768 
0x10EAE998, 38049094599507232, 87526155, 87526159, 4, 1366x768 
0x10EAE998, 38049094600165360, 87526219, 87526225, 6, 1366x768 
0x10EAE998, 38049094600831360, 87526285, 87526288, 3, 1366x768 
0x10EAE998, 38049094601508888, 87526358, 87526362, 4, 1366x768 
0x10EAE998, 38049094602177632, 87526419, 87526422, 3, 1366x768 
0x10EAE998, 38049094602852112, 87526487, 87526490, 3, 1366x768 
0x10EAE998, 38049094603514632, 87526553, 87526557, 4, 1366x768 
0x10EAE998, 38049094604179152, 87526618, 87526622, 4, 1366x768 
0x10EAE998, 38049094604845024, 87526690, 87526694, 4, 1366x768 
0x10EAE998, 38049094605513640, 87526756, 87526760, 4, 1366x768 
0x10EAE998, 38049094606171392, 87526821, 87526826, 5, 1366x768 
0x10EAE998, 38049094606849608, 87526887, 87526891, 4, 1366x768 
0x10EAE998, 38049094607518160, 87526959, 87526963, 4, 1366x768 
0x10EAE998, 38049094608188792, 87527030, 87527034, 4, 1366x768 
0x10EAE998, 38049094608862632, 87527090, 87527093, 3, 1366x768 
0x10EAE998, 38049094609531952, 87527172, 87527176, 4, 1366x768 
0x10EAE998, 38049094610199456, 87527220, 87527225, 5, 1366x768 
0x10EAE998, 38049094610868192, 87527291, 87527295, 4, 1366x768 
0x10EAE998, 38049094611537952, 87527357, 87527360, 3, 1366x768 
0x10EAE998, 38049094612207144, 87527426, 87527430, 4, 1366x768 
0x10EAE998, 38049094612865336, 87527492, 87527498, 6, 1366x768 
0x10EAE998, 38049094613534080, 87527555, 87527559, 4, 1366x768 
0x10EAE998, 38049094614193416, 87527620, 87527626, 6, 1366x768 
0x10EAE998, 38049094614861552, 87527689, 87527693, 4, 1366x768 
0x10EAE998, 38049094618210504, 87528025, 87528028, 3, 1366x768 
0x10EAE998, 38049094618872232, 87528087, 87528090, 3, 1366x768 
0x10EAE998, 38049094619540760, 87528155, 87528158, 3, 1366x768 
0x10EAE998, 38049094620207328, 87528225, 87528228, 3, 1366x768 
0x10EAE998, 38049094622886256, 87528500, 87528503, 3, 1366x768 
0x10EAE998, 38049094623546872, 87528574, 87528578, 4, 1366x768 
0x10EAE998, 38049094625555656, 87528754, 87528758, 4, 1366x768 
0x10EAE998, 38049094630894528, 87529311, 87529315, 4, 1366x768 
0x10EAE998, 38049094636237160, 87529844, 87529848, 4, 1366x768 
0x10EAE998, 38049094641578704, 87530382, 87530385, 3, 1366x768 
0x10EAE998, 38049094646921664, 87530911, 87530914, 3, 1366x768 
0x10EAE998, 38049094652266512, 87531449, 87531453, 4, 1366x768 
0x10EAE998, 38049094657600424, 87531982, 87531985, 3, 1366x768 
0x10EAE998, 38049094662947416, 87532516, 87532519, 3, 1366x768 
0x10EAE998, 38049094668305168, 87533054, 87533058, 4, 1366x768 
0x10EAE998, 38049094673631944, 87533587, 87533591, 4, 1366x768 
0x10EAE998, 38049094678966240, 87534118, 87534122, 4, 1366x768 
0x10EAE998, 38049094684300232, 87534650, 87534654, 4, 1366x768 
0x10EAE998, 38049094689632592, 87535185, 87535188, 3, 1366x768 
0x10EAE998, 38049094694968392, 87535719, 87535723, 4, 1366x768 
0x10EAE998, 38049094700312808, 87536249, 87536253, 4, 1366x768 
0x10EAE998, 38049094705659232, 87536788, 87536792, 4, 1366x768 
0x10EAE998, 38049094711004552, 87537320, 87537323, 3, 1366x768 
0x10EAE998, 38049094716349688, 87537853, 87537857, 4, 1366x768 
0x10EAE998, 38049094721692040, 87538387, 87538391, 4, 1366x768 
0x10EAE998, 38049094727029056, 87538921, 87538925, 4, 1366x768 
0x10EAE998, 38049094732384312, 87539462, 87539465, 3, 1366x768 
0x10EAE998, 38049094737724304, 87539995, 87539998, 3, 1366x768 
0x10EAE998, 38049094743050736, 87540524, 87540528, 4, 1366x768 
0x10EAE998, 38049094748391344, 87541061, 87541065, 4, 1366x768 
0x10EAE998, 38049094753733288, 87541595, 87541598, 3, 1366x768 
0x10EAE998, 38049094759071232, 87542127, 87542131, 4, 1366x768 
0x10EAE998, 38049094764404240, 87542663, 87542667, 4, 1366x768 
0x10EAE998, 38049094769730048, 87543192, 87543195, 3, 1366x768 
0x10EAE998, 38049094775076344, 87543726, 87543730, 4, 1366x768 
0x10EAE998, 38049094780403016, 87544264, 87544268, 4, 1366x768 
0x10EAE998, 38049094785734168, 87544793, 87544796, 3, 1366x768 
0x10EAE998, 38049094791070872, 87545325, 87545329, 4, 1366x768 
0x10EAE998, 38049094796428664, 87545865, 87545868, 3, 1366x768 
0x10EAE998, 38049094801743504, 87546395, 87546398, 3, 1366x768 
0x10EAE998, 38049094807102048, 87546928, 87546932, 4, 1366x768 
0x10EAE998, 38049094807765704, 87546979, 87546982, 3, 1366x768 
0x10EAE998, 38049094813105024, 87547533, 87547537, 4, 1366x768 
0x10EAE998, 38049094818430920, 87548061, 87548064, 3, 1366x768 
0x10EAE998, 38049094823765800, 87548596, 87548600, 4, 1366x768 
0x10EAE998, 38049094829125040, 87549131, 87549134, 3, 1366x768 
0x10EAE998, 38049094834445792, 87549665, 87549669, 4, 1366x768 
0x10EAE998, 38049094839786632, 87550199, 87550202, 3, 1366x768 
0x10EAE998, 38049094845127024, 87550732, 87550736, 4, 1366x768 
0x10EAE998, 38049094850474384, 87551266, 87551270, 4, 1366x768 
0x10EAE998, 38049094855809360, 87551802, 87551805, 3, 1366x768 
0x10EAE998, 38049094861154272, 87552336, 87552340, 4, 1366x768 
0x10EAE998, 38049094866519384, 87552874, 87552877, 3, 1366x768 
0x10EAE998, 38049094871889680, 87553411, 87553415, 4, 1366x768 
0x10EAE998, 38049094877242648, 87553945, 87553948, 3, 1366x768 
0x10EAE998, 38049094882581184, 87554477, 87554480, 3, 1366x768 
0x10EAE998, 38049094887916232, 87555012, 87555016, 4, 1366x768 
0x10EAE998, 38049094893269104, 87555546, 87555550, 4, 1366x768 
0x10EAE998, 38049094898592144, 87556079, 87556082, 3, 1366x768 
0x10EAE998, 38049094903932416, 87556615, 87556619, 4, 1366x768 
0x10EAE998, 38049094909277616, 87557146, 87557150, 4, 1366x768 
0x10EAE998, 38049094914625128, 87557684, 87557687, 3, 1366x768 
0x10EAE998, 38049094919969688, 87558214, 87558218, 4, 1366x768 
0x10EAE998, 38049094925318288, 87558752, 87558755, 3, 1366x768 
0x10EAE998, 38049094930662296, 87559286, 87559290, 4, 1366x768 
0x10EAE998, 38049094936015176, 87559822, 87559826, 4, 1366x768 
0x10EAE998, 38049094941372520, 87560358, 87560361, 3, 1366x768 
0x10EAE998, 38049094946717176, 87560891, 87560895, 4, 1366x768 
0x10EAE998, 38049094952063744, 87561429, 87561433, 4, 1366x768 
0x10EAE998, 38049094957395192, 87561959, 87561962, 3, 1366x768 
0x10EAE998, 38049094962722848, 87562493, 87562496, 3, 1366x768 
0x10EAE998, 38049094968053136, 87563024, 87563028, 4, 1366x768 
0x10EAE998, 38049094973394872, 87563557, 87563561, 4, 1366x768 
0x10EAE998, 38049094978724056, 87564093, 87564096, 3, 1366x768 
0x10EAE998, 38049094984084704, 87564628, 87564632, 4, 1366x768 
0x10EAE998, 38049094989423776, 87565161, 87565165, 4, 1366x768 
0x10EAE998, 38049094994771240, 87565696, 87565700, 4, 1366x768 
0x10EAE998, 38049095000098976, 87566231, 87566234, 3, 1366x768 
0x10EAE998, 38049095005415144, 87566763, 87566767, 4, 1366x768 
0x10EAE998, 38049095010762056, 87567297, 87567301, 4, 1366x768 
0x10EAE998, 38049095016103120, 87567833, 87567837, 4, 1366x768 
0x10EAE998, 38049095021444720, 87568367, 87568370, 3, 1366x768 
0x10EAE998, 38049095026779464, 87568897, 87568901, 4, 1366x768 
0x10EAE998, 38049095032131384, 87569436, 87569440, 4, 1366x768 
0x10EAE998, 38049095037465360, 87569966, 87569970, 4, 1366x768 
0x10EAE998, 38049095042803968, 87570502, 87570506, 4, 1366x768 
0x10EAE998, 38049095048149520, 87571037, 87571041, 4, 1366x768 
0x10EAE998, 38049095053493816, 87571571, 87571575, 4, 1366x768 
0x10EAE998, 38049095058839296, 87572106, 87572110, 4, 1366x768 
0x10EAE998, 38049095064192568, 87572638, 87572641, 3, 1366x768 
0x10EAE998, 38049095069527712, 87573174, 87573178, 4, 1366x768 
0x10EAE998, 38049095074886336, 87573708, 87573711, 3, 1366x768 
0x10EAE998, 38049095080203872, 87574241, 87574244, 3, 1366x768 
0x10EAE998, 38049095085537280, 87574773, 87574777, 4, 1366x768 
0x10EAE998, 38049095088205648, 87575022, 87575026, 4, 1366x768 
0x10EAE998, 38049095088873320, 87575090, 87575094, 4, 1366x768 
0x10EAE998, 38049095089541848, 87575156, 87575160, 4, 1366x768 
0x10EAE998, 38049095090209624, 87575221, 87575226, 5, 1366x768 
0x10EAE998, 38049095090878128, 87575292, 87575296, 4, 1366x768 
0x10EAE998, 38049095091535984, 87575358, 87575362, 4, 1366x768 
0x10EAE998, 38049095092204432, 87575424, 87575427, 3, 1366x768 
0x10EAE998, 38049095092873872, 87575489, 87575493, 4, 1366x768 
0x10EAE998, 38049095095541320, 87575757, 87575761, 4, 1366x768 
0x10EAE998, 38049095096209824, 87575821, 87575825, 4, 1366x768 
0x10EAE998, 38049095096881064, 87575891, 87575895, 4, 1366x768 
0x10EAE998, 38049095097547776, 87575955, 87575959, 4, 1366x768 
0x10EAE998, 38049095098213264, 87576023, 87576027, 4, 1366x768 
0x10EAE998, 38049095098884168, 87576091, 87576094, 3, 1366x768 
0x10EAE998, 38049095099556584, 87576155, 87576159, 4, 1366x768 
0x10EAE998, 38049095100219032, 87576225, 87576229, 4, 1366x768 
0x10EAE998, 38049095100885200, 87576288, 87576291, 3, 1366x768 
0x10EAE998, 38049095101553712, 87576360, 87576364, 4, 1366x768 
0x10EAE998, 38049095102223232, 87576424, 87576428, 4, 1366x768 
0x10EAE998, 38049095102893136, 87576492, 87576495, 3, 1366x768 
0x10EAE998, 38049095103559208, 87576559, 87576563, 4, 1366x768 
0x10EAE998, 38049095104231240, 87576646, 87576650, 4, 1366x768 
0x10EAE998, 38049095104900184, 87576699, 87576702, 3, 1366x768 
0x10EAE998, 38049095106238080, 87576831, 87576835, 4, 1366x768 
0x10EAE998, 38049095106902720, 87576893, 87576899, 6, 1366x768 
0x10EAE998, 38049095107572000, 87576963, 87576967, 4, 1366x768 
0x10EAE998, 38049095108244664, 87577027, 87577032, 5, 1366x768 
0x10EAE998, 38049095108912464, 87577092, 87577096, 4, 1366x768 
0x10EAE998, 38049095109584504, 87577157, 87577161, 4, 1366x768 
0x10EAE998, 38049095110255976, 87577226, 87577229, 3, 1366x768 
0x10EAE998, 38049095110924512, 87577293, 87577297, 4, 1366x768 
0x10EAE998, 38049095111590016, 87577363, 87577367, 4, 1366x768 
0x10EAE998, 38049095112258072, 87577428, 87577432, 4, 1366x768 
0x10EAE998, 38049095112927608, 87577500, 87577504, 4, 1366x768 
0x10EAE998, 38049095113598864, 87577567, 87577571, 4, 1366x768 
0x10EAE998, 38049095114272672, 87577634, 87577638, 4, 1366x768 
0x10EAE998, 38049095114941232, 87577700, 87577706, 6, 1366x768 
0x10EAE998, 38049095115609688, 87577766, 87577770, 4, 1366x768 
0x10EAE998, 38049095116278432, 87577832, 87577836, 4, 1366x768 
0x10EAE998, 38049095116951416, 87577919, 87577922, 3, 1366x768 
0x10EAE998, 38049095119616376, 87578162, 87578166, 4, 1366x768 
0x10EAE998, 38049095120282232, 87578231, 87578235, 4, 1366x768 
0x10EAE998, 38049095120954984, 87578296, 87578300, 4, 1366x768 
0x10EAE998, 38049095121624128, 87578361, 87578364, 3, 1366x768 
0x10EAE998, 38049095122292216, 87578432, 87578435, 3, 1366x768 
0x10EAE998, 38049095122961248, 87578499, 87578502, 3, 1366x768 
0x10EAE998, 38049095123631824, 87578584, 87578588, 4, 1366x768 
0x10EAE998, 38049095124303344, 87578650, 87578653, 3, 1366x768 
0x10EAE998, 38049095124969856, 87578703, 87578709, 6, 1366x768 
0x10EAE998, 38049095125655776, 87578774, 87578780, 6, 1366x768 
0x10EAE998, 38049095126370152, 87578846, 87578850, 4, 1366x768 
0x10EAE998, 38049095127191688, 87578936, 87578948, 12, 1366x768 
0x10EAE998, 38049095127904456, 87579007, 87579011, 4, 1366x768 
0x10EAE998, 38049095128570112, 87579060, 87579067, 7, 1366x768 
0x10EAE998, 38049095129251080, 87579133, 87579137, 4, 1366x768 
0x10EAE998, 38049095129918208, 87579193, 87579197, 4, 1366x768 
0x10EAE998, 38049095130584288, 87579264, 87579268, 4, 1366x768 
0x10EAE998, 38049095131252504, 87579331, 87579334, 3, 1366x768 
0x10EAE998, 38049095135908192, 87579796, 87579799, 3, 1366x768 
0x10EAE998, 38049095136576360, 87579861, 87579868, 7, 1366x768 
0x10EAE998, 38049095137249928, 87579933, 87579937, 4, 1366x768 
0x10EAE998, 38049095137918192, 87579994, 87579998, 4, 1366x768 
0x10EAE998, 38049095138585344, 87580061, 87580065, 4, 1366x768 
0x10EAE998, 38049095139253448, 87580133, 87580137, 4, 1366x768 
0x10EAE998, 38049095139922640, 87580199, 87580203, 4, 1366x768 
0x10EAE998, 38049095140590944, 87580266, 87580269, 3, 1366x768 
0x10EAE998, 38049095141260576, 87580327, 87580330, 3, 1366x768 
0x10EAE998, 38049095141928128, 87580393, 87580396, 3, 1366x768 
0x10EAE998, 38049095142594512, 87580467, 87580471, 4, 1366x768 
0x10EAE998, 38049095143261224, 87580527, 87580530, 3, 1366x768 
0x10EAE998, 38049095143926264, 87580596, 87580600, 4, 1366x768 
0x10EAE998, 38049095144595952, 87580678, 87580681, 3, 1366x768 
0x10EAE998, 38049095147939496, 87581009, 87581012, 3, 1366x768 
0x10EAE998, 38049095148606456, 87581060, 87581063, 3, 1366x768 
0x10EAE998, 38049095149279040, 87581130, 87581134, 4, 1366x768 
0x10EAE998, 38049095149950656, 87581199, 87581203, 4, 1366x768 
0x10EAE998, 38049095150624808, 87581264, 87581268, 4, 1366x768 
0x10EAE998, 38049095151291984, 87581329, 87581334, 5, 1366x768 
0x10EAE998, 38049095151955192, 87581398, 87581402, 4, 1366x768 
0x10EAE998, 38049095152628416, 87581483, 87581486, 3, 1366x768 
0x10EAE998, 38049095154623216, 87581682, 87581686, 4, 1366x768 
0x10EAE998, 38049095157296744, 87581931, 87581934, 3, 1366x768 
0x10EAE998, 38049095157964184, 87581996, 87582000, 4, 1366x768 
0x10EAE998, 38049095158630216, 87582064, 87582068, 4, 1366x768 
0x10EAE998, 38049095159303888, 87582148, 87582151, 3, 1366x768 
0x10EAE998, 38049095159963960, 87582198, 87582202, 4, 1366x768 
0x10EAE998, 38049095160635696, 87582264, 87582268, 4, 1366x768 
0x10EAE998, 38049095161305872, 87582332, 87582335, 3, 1366x768 
0x10EAE998, 38049095161973856, 87582416, 87582419, 3, 1366x768 
0x10EAE998, 38049095162647552, 87582483, 87582486, 3, 1366x768 
0x10EAE998, 38049095163315632, 87582535, 87582538, 3, 1366x768 
0x10EAE998, 38049095165993160, 87582808, 87582811, 3, 1366x768 
0x10EAE998, 38049095166664232, 87582888, 87582891, 3, 1366x768 
0x10EAE998, 38049095167342624, 87582955, 87582958, 3, 1366x768 
0x10EAE998, 38049095170029560, 87583203, 87583207, 4, 1366x768 
0x10EAE998, 38049095170696848, 87583270, 87583274, 4, 1366x768 
0x10EAE998, 38049095171369688, 87583338, 87583342, 4, 1366x768 
0x10EAE998, 38049095172034504, 87583405, 87583409, 4, 1366x768 
0x10EAE998, 38049095172701352, 87583491, 87583494, 3, 1366x768 
0x10EAE998, 38049095173372928, 87583560, 87583563, 3, 1366x768 
0x10EAE998, 38049095176033064, 87583809, 87583813, 4, 1366x768 
0x10EAE998, 38049095176700872, 87583874, 87583879, 5, 1366x768 
0x10EAE998, 38049095177368912, 87583938, 87583941, 3, 1366x768 
0x10EAE998, 38049095178032368, 87584006, 87584010, 4, 1366x768 
0x10EAE998, 38049095178700568, 87584070, 87584075, 5, 1366x768 
0x10EAE998, 38049095179368808, 87584142, 87584145, 3, 1366x768 
0x10EAE998, 38049095180030896, 87584211, 87584215, 4, 1366x768 
0x10EAE998, 38049095180688816, 87584270, 87584275, 5, 1366x768 
0x10EAE998, 38049095181360712, 87584341, 87584345, 4, 1366x768 
0x10EAE998, 38049095182028888, 87584408, 87584411, 3, 1366x768 
0x10EAE998, 38049095182697648, 87584474, 87584477, 3, 1366x768 
0x10EAE998, 38049095183365400, 87584540, 87584544, 4, 1366x768 
0x10EAE998, 38049095184037096, 87584605, 87584609, 4, 1366x768 
0x10EAE998, 38049095184702328, 87584670, 87584673, 3, 1366x768 
0x10EAE998, 38049095185370320, 87584736, 87584739, 3, 1366x768 
0x10EAE998, 38049095186040080, 87584806, 87584810, 4, 1366x768 
0x10EAE998, 38049095186708240, 87584881, 87584885, 4, 1366x768 
0x10EAE998, 38049095187378648, 87584947, 87584951, 4, 1366x768 
0x10EAE998, 38049095188039912, 87585006, 87585010, 4, 1366x768 
0x10EAE998, 38049095188703624, 87585071, 87585075, 4, 1366x768 
0x10EAE998, 38049095192748768, 87585482, 87585487, 5, 1366x768 
0x10EAE998, 38049095193415384, 87585547, 87585550, 3, 1366x768 
0x10EAE998, 38049095194082664, 87585612, 87585616, 4, 1366x768 
0x10EAE998, 38049095194751096, 87585684, 87585688, 4, 1366x768 
0x10EAE998, 38049095195419120, 87585750, 87585758, 8, 1366x768 
0x10EAE998, 38049095196082576, 87585816, 87585820, 4, 1366x768 
0x10EAE998, 38049095196750624, 87585877, 87585880, 3, 1366x768 
0x10EAE998, 38049095197418888, 87585961, 87585965, 4, 1366x768 
0x10EAE998, 38049095200751832, 87586298, 87586302, 4, 1366x768 
0x10EAE998, 38049095201417928, 87586345, 87586348, 3, 1366x768 
0x10EAE998, 38049095202085720, 87586415, 87586418, 3, 1366x768 
0x10EAE998, 38049095202754640, 87586479, 87586482, 3, 1366x768 
0x10EAE998, 38049095203412624, 87586542, 87586546, 4, 1366x768 
0x10EAE998, 38049095204083728, 87586609, 87586612, 3, 1366x768 
0x10EAE998, 38049095204753104, 87586694, 87586698, 4, 1366x768 
0x10EAE998, 38049095205424320, 87586763, 87586766, 3, 1366x768 
0x10EAE998, 38049095210766768, 87587301, 87587304, 3, 1366x768 
0x10EAE998, 38049095215424104, 87587743, 87587747, 4, 1366x768 
0x10EAE998, 38049095216753640, 87587878, 87587881, 3, 1366x768 
0x10EAE998, 38049095217421880, 87587961, 87587964, 3, 1366x768 
0x10EAE998, 38049095221417688, 87588345, 87588349, 4, 1366x768 
0x10EAE998, 38049095222089000, 87588411, 87588415, 4, 1366x768 
0x10EAE998, 38049095222754576, 87588481, 87588484, 3, 1366x768 
0x10EAE998, 38049095223421568, 87588542, 87588546, 4, 1366x768 
0x10EAE998, 38049095224095176, 87588628, 87588632, 4, 1366x768 
0x10EAE998, 38049095224763840, 87588697, 87588701, 4, 1366x768 
0x10EAE998, 38049095230108592, 87589230, 87589234, 4, 1366x768 
0x10EAE998, 38049095235448016, 87589765, 87589769, 4, 1366x768 
0x10EAE998, 38049095240801104, 87590299, 87590303, 4, 1366x768 
0x10EAE998, 38049095246127648, 87590831, 87590835, 4, 1366x768 
0x10EAE998, 38049095251469856, 87591366, 87591370, 4, 1366x768 
0x10EAE998, 38049095256816544, 87591903, 87591906, 3, 1366x768 
0x10EAE998, 38049095262172592, 87592441, 87592444, 3, 1366x768 
0x10EAE998, 38049095267518464, 87592974, 87592977, 3, 1366x768 
0x10EAE998, 38049095272857696, 87593507, 87593510, 3, 1366x768 
0x10EAE998, 38049095278189640, 87594041, 87594045, 4, 1366x768 
0x10EAE998, 38049095283527008, 87594571, 87594574, 3, 1366x768 
0x10EAE998, 38049095288856168, 87595108, 87595112, 4, 1366x768 
0x10EAE998, 38049095294197368, 87595641, 87595644, 3, 1366x768 
0x10EAE998, 38049095299542984, 87596177, 87596181, 4, 1366x768 
0x10EAE998, 38049095304880992, 87596710, 87596714, 4, 1366x768 
0x10EAE998, 38049095306881968, 87596891, 87596894, 3, 1366x768 
0x10EAE998, 38049095307555080, 87596956, 87596959, 3, 1366x768 
0x10EAE998, 38049095308221232, 87597023, 87597027, 4, 1366x768 
0x10EAE998, 38049095308896192, 87597090, 87597093, 3, 1366x768 
0x10EAE998, 38049095309569576, 87597157, 87597161, 4, 1366x768 
0x10EAE998, 38049095310245008, 87597227, 87597230, 3, 1366x768 
0x10EAE998, 38049095310913128, 87597291, 87597294, 3, 1366x768 
0x10EAE998, 38049095311576568, 87597362, 87597365, 3, 1366x768 
0x10EAE998, 38049095312245160, 87597427, 87597429, 2, 1366x768 
0x10EAE998, 38049095312918496, 87597494, 87597498, 4, 1366x768 
0x10EAE998, 38049095313587904, 87597559, 87597563, 4, 1366x768 
0x10EAE998, 38049095314254024, 87597629, 87597632, 3, 1366x768 
0x10EAE998, 38049095314916640, 87597694, 87597698, 4, 1366x768 
0x10EAE998, 38049095315588736, 87597763, 87597767, 4, 1366x768 
0x10EAE998, 38049095316254544, 87597827, 87597830, 3, 1366x768 
0x10EAE998, 38049095316915984, 87597897, 87597901, 4, 1366x768 
0x10EAE998, 38049095317588448, 87597958, 87597961, 3, 1366x768 
0x10EAE998, 38049095318258776, 87598025, 87598029, 4, 1366x768 
0x10EAE998, 38049095318932792, 87598097, 87598101, 4, 1366x768 
0x10EAE998, 38049095319599064, 87598161, 87598164, 3, 1366x768 
0x10EAE998, 38049095320268184, 87598228, 87598232, 4, 1366x768 
0x10EAE998, 38049095320938664, 87598297, 87598300, 3, 1366x768 
0x10EAE998, 38049095321605248, 87598363, 87598366, 3, 1366x768 
0x10EAE998, 38049095322269760, 87598430, 87598433, 3, 1366x768 
0x10EAE998, 38049095322941000, 87598492, 87598496, 4, 1366x768 
0x10EAE998, 38049095323609928, 87598563, 87598567, 4, 1366x768 
0x10EAE998, 38049095324280472, 87598632, 87598635, 3, 1366x768 
0x10EAE998, 38049095324949016, 87598698, 87598701, 3, 1366x768 
0x10EAE998, 38049095325622456, 87598762, 87598766, 4, 1366x768 
0x10EAE998, 38049095326289984, 87598833, 87598837, 4, 1366x768 
0x10EAE998, 38049095326957728, 87598900, 87598904, 4, 1366x768 
0x10EAE998, 38049095327617080, 87598962, 87598966, 4, 1366x768 
0x10EAE998, 38049095328276912, 87599029, 87599033, 4, 1366x768 
0x10EAE998, 38049095328944672, 87599118, 87599121, 3, 1366x768 
0x10EAE998, 38049095329613824, 87599184, 87599187, 3, 1366x768 
0x10EAE998, 38049095334943640, 87599717, 87599720, 3, 1366x768 
0x10EAE998, 38049095340265048, 87600244, 87600248, 4, 1366x768 
0x10EAE998, 38049095345611552, 87600780, 87600784, 4, 1366x768 
0x10EAE998, 38049095350938376, 87601317, 87601321, 4, 1366x768 
0x10EAE998, 38049095356270872, 87601849, 87601853, 4, 1366x768 
0x10EAE998, 38049095361623888, 87602382, 87602386, 4, 1366x768 
0x10EAE998, 38049095366952088, 87602918, 87602922, 4, 1366x768 
0x10EAE998, 38049095372286280, 87603450, 87603454, 4, 1366x768 
0x10EAE998, 38049095377617320, 87603985, 87603989, 4, 1366x768 
0x10EAE998, 38049095382954072, 87604518, 87604522, 4, 1366x768 
0x10EAE998, 38049095388304648, 87605049, 87605053, 4, 1366x768 
0x10EAE998, 38049095393616264, 87605581, 87605584, 3, 1366x768 
0x10EAE998, 38049095398940704, 87606115, 87606118, 3, 1366x768 
0x10EAE998, 38049095404281040, 87606647, 87606651, 4, 1366x768 
0x10EAE998, 38049095407604408, 87606962, 87606965, 3, 1366x768 
0x10EAE998, 38049095412959688, 87607514, 87607518, 4, 1366x768 
0x10EAE998, 38049095418310064, 87608051, 87608055, 4, 1366x768 
0x10EAE998, 38049095423631912, 87608584, 87608588, 4, 1366x768 
0x10EAE998, 38049095428951456, 87609116, 87609119, 3, 1366x768 
0x10EAE998, 38049095434288656, 87609651, 87609655, 4, 1366x768 
0x10EAE998, 38049095439611328, 87610180, 87610184, 4, 1366x768 
0x10EAE998, 38049095440933272, 87610297, 87610301, 4, 1366x768 
0x10EAE998, 38049095441600976, 87610364, 87610368, 4, 1366x768 
0x10EAE998, 38049095442270472, 87610431, 87610435, 4, 1366x768 
0x10EAE998, 38049095442937120, 87610494, 87610498, 4, 1366x768 
0x10EAE998, 38049095443611824, 87610564, 87610567, 3, 1366x768 
0x10EAE998, 38049095444280072, 87610630, 87610633, 3, 1366x768 
0x10EAE998, 38049095444949424, 87610695, 87610698, 3, 1366x768 
0x10EAE998, 38049095445624960, 87610765, 87610768, 3, 1366x768 
0x10EAE998, 38049095446296216, 87610830, 87610833, 3, 1366x768 
0x10EAE998, 38049095446963200, 87610898, 87610902, 4, 1366x768 
0x10EAE998, 38049095447629264, 87610966, 87610970, 4, 1366x768 
0x10EAE998, 38049095448957200, 87611099, 87611105, 6, 1366x768 
0x10EAE998, 38049095449632000, 87611168, 87611172, 4, 1366x768 
0x10EAE998, 38049095450296072, 87611246, 87611250, 4, 1366x768 
0x10EAE998, 38049095450962896, 87611319, 87611323, 4, 1366x768 
0x10EAE998, 38049095456303904, 87611849, 87611852, 3, 1366x768 
0x10EAE998, 38049095461646360, 87612383, 87612386, 3, 1366x768 
0x10EAE998, 38049095465659128, 87612766, 87612770, 4, 1366x768 
0x10EAE998, 38049095466330680, 87612834, 87612838, 4, 1366x768 
0x10EAE998, 38049095467002592, 87612902, 87612907, 5, 1366x768 
0x10EAE998, 38049095467667040, 87612967, 87612971, 4, 1366x768 
0x10EAE998, 38049095468337080, 87613035, 87613039, 4, 1366x768 
0x10EAE998, 38049095469010304, 87613103, 87613107, 4, 1366x768 
0x10EAE998, 38049095469684632, 87613168, 87613172, 4, 1366x768 
0x10EAE998, 38049095470351088, 87613237, 87613241, 4, 1366x768 
0x10EAE998, 38049095471018992, 87613302, 87613305, 3, 1366x768 
0x10EAE998, 38049095471689216, 87613372, 87613376, 4, 1366x768 
0x10EAE998, 38049095472362104, 87613435, 87613438, 3, 1366x768 
0x10EAE998, 38049095473026560, 87613504, 87613508, 4, 1366x768 
0x10EAE998, 38049095473698904, 87613575, 87613578, 3, 1366x768 
0x10EAE998, 38049095474371400, 87613638, 87613642, 4, 1366x768 
0x10EAE998, 38049095475042304, 87613702, 87613706, 4, 1366x768 
0x10EAE998, 38049095475714008, 87613774, 87613778, 4, 1366x768 
0x10EAE998, 38049095476386384, 87613840, 87613844, 4, 1366x768 
0x10EAE998, 38049095477045136, 87613907, 87613910, 3, 1366x768 
0x10EAE998, 38049095477720088, 87613975, 87613979, 4, 1366x768 
0x10EAE998, 38049095478384360, 87614059, 87614062, 3, 1366x768 
0x10EAE998, 38049095483708008, 87614592, 87614596, 4, 1366x768 
0x10EAE998, 38049095489036960, 87615127, 87615130, 3, 1366x768 
0x10EAE998, 38049095489701424, 87615172, 87615176, 4, 1366x768 
0x10EAE998, 38049095490362224, 87615240, 87615244, 4, 1366x768 
0x10EAE998, 38049095491030448, 87615304, 87615307, 3, 1366x768 
0x10EAE998, 38049095491704912, 87615370, 87615374, 4, 1366x768 
0x10EAE998, 38049095492372880, 87615441, 87615447, 6, 1366x768 
0x10EAE998, 38049095493042376, 87615513, 87615516, 3, 1366x768 
0x10EAE998, 38049095493709448, 87615572, 87615575, 3, 1366x768 
0x10EAE998, 38049095494375120, 87615642, 87615646, 4, 1366x768 
0x10EAE998, 38049095495045816, 87615707, 87615711, 4, 1366x768 
0x10EAE998, 38049095495719224, 87615776, 87615779, 3, 1366x768 
0x10EAE998, 38049095496386976, 87615842, 87615846, 4, 1366x768 
0x10EAE998, 38049095497063528, 87615905, 87615909, 4, 1366x768 
0x10EAE998, 38049095497738384, 87615977, 87615981, 4, 1366x768 
0x10EAE998, 38049095498404272, 87616043, 87616047, 4, 1366x768 
0x10EAE998, 38049095499070928, 87616108, 87616111, 3, 1366x768 
0x10EAE998, 38049095499736616, 87616174, 87616178, 4, 1366x768 
0x10EAE998, 38049095500407216, 87616262, 87616266, 4, 1366x768 
0x10EAE998, 38049095501078496, 87616331, 87616335, 4, 1366x768 
0x10EAE998, 38049095506426184, 87616861, 87616865, 4, 1366x768 
0x10EAE998, 38049095511758784, 87617397, 87617401, 4, 1366x768 
0x10EAE998, 38049095517108224, 87617929, 87617933, 4, 1366x768 
0x10EAE998, 38049095522448552, 87618467, 87618470, 3, 1366x768 
0x10EAE998, 38049095527803872, 87619002, 87619006, 4, 1366x768 
0x10EAE998, 38049095533150984, 87619536, 87619540, 4, 1366x768 
0x10EAE998, 38049095538500808, 87620073, 87620077, 4, 1366x768 
0x10EAE998, 38049095543832976, 87620605, 87620608, 3, 1366x768 
0x10EAE998, 38049095549185144, 87621138, 87621142, 4, 1366x768 
0x10EAE998, 38049095554523512, 87621674, 87621677, 3, 1366x768 
0x10EAE998, 38049095559865744, 87622210, 87622214, 4, 1366x768 
0x10EAE998, 38049095565214544, 87622739, 87622743, 4, 1366x768 
0x10EAE998, 38049095570553632, 87623275, 87623279, 4, 1366x768 
0x10EAE998, 38049095575884896, 87623810, 87623814, 4, 1366x768 
0x10EAE998, 38049095581228544, 87624343, 87624346, 3, 1366x768 
0x10EAE998, 38049095586566176, 87624879, 87624883, 4, 1366x768 
0x10EAE998, 38049095591914160, 87625414, 87625418, 4, 1366x768 
0x10EAE998, 38049095597232376, 87625942, 87625945, 3, 1366x768 
0x10EAE998, 38049095602582496, 87626478, 87626481, 3, 1366x768 
0x10EAE998, 38049095607948920, 87627016, 87627020, 4, 1366x768 
0x10EAE998, 38049095613280576, 87627551, 87627555, 4, 1366x768 
0x10EAE998, 38049095618618184, 87628083, 87628086, 3, 1366x768 
0x10EAE998, 38049095623940936, 87628612, 87628616, 4, 1366x768 
0x10EAE998, 38049095629283632, 87629151, 87629155, 4, 1366x768 
0x10EAE998, 38049095634607288, 87629681, 87629684, 3, 1366x768 
0x10EAE998, 38049095639932880, 87630210, 87630214, 4, 1366x768 
0x10EAE998, 38049095645265960, 87630750, 87630753, 3, 1366x768 
0x10EAE998, 38049095650605760, 87631283, 87631286, 3, 1366x768 
0x10EAE998, 38049095655952896, 87631816, 87631820, 4, 1366x768 
0x10EAE998, 38049095661307680, 87632351, 87632355, 4, 1366x768 
0x10EAE998, 38049095666646688, 87632889, 87632892, 3, 1366x768 
0x10EAE998, 38049095672000016, 87633420, 87633424, 4, 1366x768 
0x10EAE998, 38049095677338928, 87633956, 87633960, 4, 1366x768 
0x10EAE998, 38049095682674296, 87634485, 87634489, 4, 1366x768 
0x10EAE998, 38049095688020512, 87635022, 87635025, 3, 1366x768 
0x10EAE998, 38049095693366176, 87635556, 87635560, 4, 1366x768 
0x10EAE998, 38049095698708432, 87636089, 87636093, 4, 1366x768 
0x10EAE998, 38049095704043552, 87636625, 87636629, 4, 1366x768 
0x10EAE998, 38049095709383824, 87637157, 87637160, 3, 1366x768 
0x10EAE998, 38049095714727576, 87637693, 87637697, 4, 1366x768 
0x10EAE998, 38049095716059344, 87637812, 87637816, 4, 1366x768 
0x10EAE998, 38049095716727752, 87637877, 87637881, 4, 1366x768 
0x10EAE998, 38049095717395696, 87637942, 87637946, 4, 1366x768 
0x10EAE998, 38049095718068552, 87638007, 87638010, 3, 1366x768 
0x10EAE998, 38049095718736032, 87638076, 87638080, 4, 1366x768 
0x10EAE998, 38049095719413504, 87638140, 87638144, 4, 1366x768 
0x10EAE998, 38049095720074256, 87638209, 87638211, 2, 1366x768 
0x10EAE998, 38049095720739096, 87638277, 87638280, 3, 1366x768 
0x10EAE998, 38049095721398680, 87638340, 87638344, 4, 1366x768 
0x10EAE998, 38049095722070832, 87638407, 87638410, 3, 1366x768 
0x10EAE998, 38049095722737376, 87638476, 87638479, 3, 1366x768 
0x10EAE998, 38049095723405672, 87638542, 87638545, 3, 1366x768 
0x10EAE998, 38049095724074512, 87638609, 87638612, 3, 1366x768 
0x10EAE998, 38049095724742888, 87638676, 87638679, 3, 1366x768 
0x10EAE998, 38049095725402200, 87638740, 87638743, 3, 1366x768 
0x10EAE998, 38049095726075528, 87638808, 87638812, 4, 1366x768 
0x10EAE998, 38049095726744208, 87638877, 87638880, 3, 1366x768 
0x10EAE998, 38049095727418664, 87638943, 87638946, 3, 1366x768 
0x10EAE998, 38049095728086752, 87639010, 87639013, 3, 1366x768 
0x10EAE998, 38049095728757568, 87639079, 87639082, 3, 1366x768 
0x10EAE998, 38049095729417024, 87639146, 87639150, 4, 1366x768 
0x10EAE998, 38049095730086112, 87639210, 87639214, 4, 1366x768 
0x10EAE998, 38049095730755760, 87639276, 87639279, 3, 1366x768 
0x10EAE998, 38049095731423960, 87639345, 87639348, 3, 1366x768 
0x10EAE998, 38049095732100128, 87639409, 87639412, 3, 1366x768 
0x10EAE998, 38049095732768056, 87639478, 87639482, 4, 1366x768 
0x10EAE998, 38049095733433872, 87639544, 87639548, 4, 1366x768 
0x10EAE998, 38049095734097144, 87639613, 87639616, 3, 1366x768 
0x10EAE998, 38049095734761320, 87639677, 87639680, 3, 1366x768 
0x10EAE998, 38049095735428848, 87639746, 87639749, 3, 1366x768 
0x10EAE998, 38049095736088720, 87639812, 87639816, 4, 1366x768 
0x10EAE998, 38049095736759712, 87639879, 87639883, 4, 1366x768 
0x10EAE998, 38049095737429808, 87639942, 87639945, 3, 1366x768 
0x10EAE998, 38049095738089600, 87640010, 87640013, 3, 1366x768 
0x10EAE998, 38049095738759104, 87640079, 87640083, 4, 1366x768 
0x10EAE998, 38049095739424960, 87640144, 87640147, 3, 1366x768 
0x10EAE998, 38049095742751976, 87640478, 87640481, 3, 1366x768 
0x10EAE998, 38049095743417104, 87640544, 87640548, 4, 1366x768 
0x10EAE998, 38049095744084920, 87640630, 87640633, 3, 1366x768 
0x10EAE998, 38049095744747192, 87640694, 87640699, 5, 1366x768 
0x10EAE998, 38049095750081688, 87641231, 87641235, 4, 1366x768 
0x10EAE998, 38049095755407672, 87641761, 87641764, 3, 1366x768 
0x10EAE998, 38049095760739472, 87642294, 87642298, 4, 1366x768 
0x10EAE998, 38049095766087144, 87642811, 87642815, 4, 1366x768 
0x10EAE998, 38049095766750072, 87642878, 87642881, 3, 1366x768 
0x10EAE998, 38049095767424952, 87642943, 87642946, 3, 1366x768 
0x10EAE998, 38049095768089224, 87643011, 87643015, 4, 1366x768 
0x10EAE998, 38049095768757656, 87643078, 87643082, 4, 1366x768 
0x10EAE998, 38049095769428560, 87643146, 87643149, 3, 1366x768 
0x10EAE998, 38049095770096544, 87643210, 87643214, 4, 1366x768 
0x10EAE998, 38049095770768216, 87643280, 87643284, 4, 1366x768 
0x10EAE998, 38049095771435624, 87643366, 87643370, 4, 1366x768 
0x10EAE998, 38049095776771032, 87643895, 87643898, 3, 1366x768 
0x10EAE998, 38049095782115392, 87644432, 87644436, 4, 1366x768 
0x10EAE998, 38049095787418488, 87644961, 87644965, 4, 1366x768 
0x10EAE998, 38049095792755616, 87645494, 87645497, 3, 1366x768 
0x10EAE998, 38049095798090368, 87646027, 87646031, 4, 1366x768 
0x10EAE998, 38049095803407744, 87646564, 87646567, 3, 1366x768 
0x10EAE998, 38049095808754528, 87647094, 87647098, 4, 1366x768 
0x10EAE998, 38049095814085080, 87647630, 87647634, 4, 1366x768 
0x10EAE998, 38049095819433352, 87648165, 87648169, 4, 1366x768 
0x10EAE998, 38049095824747464, 87648699, 87648703, 4, 1366x768 
0x10EAE998, 38049095830086808, 87649228, 87649231, 3, 1366x768 
0x10EAE998, 38049095835409488, 87649762, 87649766, 4, 1366x768 
0x10EAE998, 38049095839412128, 87650145, 87650148, 3, 1366x768 
0x10EAE998, 38049095840080472, 87650209, 87650212, 3, 1366x768 
0x10EAE998, 38049095840753624, 87650280, 87650284, 4, 1366x768 
0x10EAE998, 38049095841424000, 87650361, 87650364, 3, 1366x768 
0x10EAE998, 38049095846761592, 87650895, 87650898, 3, 1366x768 
0x10EAE998, 38049095852103528, 87651429, 87651433, 4, 1366x768 
0x10EAE998, 38049095857449456, 87651964, 87651968, 4, 1366x768 
0x10EAE998, 38049095862805888, 87652498, 87652502, 4, 1366x768 
0x10EAE998, 38049095868151928, 87653036, 87653040, 4, 1366x768 
0x10EAE998, 38049095873490312, 87653570, 87653574, 4, 1366x768 
0x10EAE998, 38049095878817416, 87654104, 87654108, 4, 1366x768 
0x10EAE998, 38049095884159080, 87654636, 87654639, 3, 1366x768 
0x10EAE998, 38049095889493728, 87655168, 87655171, 3, 1366x768 
0x10EAE998, 38049095894858616, 87655704, 87655708, 4, 1366x768 
0x10EAE998, 38049095900201984, 87656240, 87656243, 3, 1366x768 
0x10EAE998, 38049095905537936, 87656775, 87656778, 3, 1366x768 
0x10EAE998, 38049095910878784, 87657307, 87657311, 4, 1366x768 
0x10EAE998, 38049095916203576, 87657841, 87657845, 4, 1366x768 
0x10EAE998, 38049095921555968, 87658379, 87658382, 3, 1366x768 
0x10EAE998, 38049095926900384, 87658911, 87658915, 4, 1366x768 
0x10EAE998, 38049095932240168, 87659443, 87659446, 3, 1366x768 
0x10EAE998, 38049095937559784, 87659976, 87659979, 3, 1366x768 
0x10EAE998, 38049095942895632, 87660507, 87660511, 4, 1366x768 
0x10EAE998, 38049095948240032, 87661046, 87661050, 4, 1366x768 
0x10EAE998, 38049095953596608, 87661580, 87661584, 4, 1366x768 
0x10EAE998, 38049095958956896, 87662119, 87662122, 3, 1366x768 
0x10EAE998, 38049095964291472, 87662651, 87662654, 3, 1366x768 
0x10EAE998, 38049095969653664, 87663189, 87663192, 3, 1366x768 
0x10EAE998, 38049095974994016, 87663718, 87663721, 3, 1366x768 
0x10EAE998, 38049095980332400, 87664254, 87664258, 4, 1366x768 
0x10EAE998, 38049095985671200, 87664788, 87664791, 3, 1366x768 
0x10EAE998, 38049095991000488, 87665319, 87665323, 4, 1366x768 
0x10EAE998, 38049095996368264, 87665859, 87665863, 4, 1366x768 
0x10EAE998, 38049096001704296, 87666392, 87666396, 4, 1366x768 
0x10EAE998, 38049096007052992, 87666926, 87666930, 4, 1366x768 
0x10EAE998, 38049096007720064, 87666970, 87666974, 4, 1366x768 
0x10EAE998, 38049096013057384, 87667527, 87667531, 4, 1366x768 
0x10EAE998, 38049096018415208, 87668060, 87668064, 4, 1366x768 
0x10EAE998, 38049096023754784, 87668598, 87668602, 4, 1366x768 
0x10EAE998, 38049096029103952, 87669133, 87669137, 4, 1366x768 
0x10EAE998, 38049096034456696, 87669665, 87669668, 3, 1366x768 
0x10EAE998, 38049096039807368, 87670202, 87670206, 4, 1366x768 
0x10EAE998, 38049096045133792, 87670731, 87670735, 4, 1366x768 
0x10EAE998, 38049096050475088, 87671268, 87671272, 4, 1366x768 
0x10EAE998, 38049096055816208, 87671800, 87671804, 4, 1366x768 
0x10EAE998, 38049096061158136, 87672339, 87672343, 4, 1366x768 
0x10EAE998, 38049096066477104, 87672869, 87672872, 3, 1366x768 
0x10EAE998, 38049096071820032, 87673403, 87673406, 3, 1366x768 
0x10EAE998, 38049096077155152, 87673934, 87673939, 5, 1366x768 
0x10EAE998, 38049096082485712, 87674469, 87674473, 4, 1366x768 
0x10EAE998, 38049096087815896, 87675002, 87675005, 3, 1366x768 
0x10EAE998, 38049096093155272, 87675538, 87675541, 3, 1366x768 
0x10EAE998, 38049096098514536, 87676071, 87676074, 3, 1366x768 
0x10EAE998, 38049096103861312, 87676605, 87676609, 4, 1366x768 
0x10EAE998, 38049096109218384, 87677143, 87677147, 4, 1366x768 
0x10EAE998, 38049096111233536, 87677324, 87677328, 4, 1366x768 
0x10EAE998, 38049096111902024, 87677391, 87677395, 4, 1366x768 
0x10EAE998, 38049096112571040, 87677458, 87677462, 4, 1366x768 
0x10EAE998, 38049096113239272, 87677528, 87677531, 3, 1366x768 
0x10EAE998, 38049096113897904, 87677594, 87677598, 4, 1366x768 
0x10EAE998, 38049096114575536, 87677660, 87677663, 3, 1366x768 
0x10EAE998, 38049096115248168, 87677727, 87677730, 3, 1366x768 
0x10EAE998, 38049096115914936, 87677795, 87677798, 3, 1366x768 
0x10EAE998, 38049096116586328, 87677859, 87677862, 3, 1366x768 
0x10EAE998, 38049096117255176, 87677927, 87677930, 3, 1366x768 
0x10EAE998, 38049096117927944, 87677994, 87677998, 4, 1366x768 
0x10EAE998, 38049096118594408, 87678062, 87678066, 4, 1366x768 
0x10EAE998, 38049096119261408, 87678128, 87678132, 4, 1366x768 
0x10EAE998, 38049096119930136, 87678210, 87678214, 4, 1366x768 
0x10EAE998, 38049096120603680, 87678281, 87678284, 3, 1366x768 
0x10EAE998, 38049096121940640, 87678394, 87678398, 4, 1366x768 
0x10EAE998, 38049096122608368, 87678465, 87678473, 8, 1366x768 
0x10EAE998, 38049096123276544, 87678531, 87678536, 5, 1366x768 
0x10EAE998, 38049096123945056, 87678596, 87678605, 9, 1366x768 
0x10EAE998, 38049096124612400, 87678663, 87678668, 5, 1366x768 
0x10EAE998, 38049096125280624, 87678729, 87678733, 4, 1366x768 
0x10EAE998, 38049096126615576, 87678862, 87678866, 4, 1366x768 
0x10EAE998, 38049096127282632, 87678928, 87678932, 4, 1366x768 
0x10EAE998, 38049096127952208, 87678995, 87678999, 4, 1366x768 
0x10EAE998, 38049096128620480, 87679066, 87679070, 4, 1366x768 
0x10EAE998, 38049096129288512, 87679132, 87679135, 3, 1366x768 
0x10EAE998, 38049096129956336, 87679200, 87679203, 3, 1366x768 
0x10EAE998, 38049096130615216, 87679262, 87679266, 4, 1366x768 
0x10EAE998, 38049096131281328, 87679330, 87679334, 4, 1366x768 
0x10EAE998, 38049096131949856, 87679397, 87679401, 4, 1366x768 
0x10EAE998, 38049096132619280, 87679462, 87679466, 4, 1366x768 
0x10EAE998, 38049096133284208, 87679528, 87679532, 4, 1366x768 
0x10EAE998, 38049096133955216, 87679601, 87679605, 4, 1366x768 
0x10EAE998, 38049096134623776, 87679672, 87679676, 4, 1366x768 
0x10EAE998, 38049096135291640, 87679736, 87679739, 3, 1366x768 
0x10EAE998, 38049096135959888, 87679801, 87679805, 4, 1366x768 
0x10EAE998, 38049096136628128, 87679866, 87679870, 4, 1366x768 
0x10EAE998, 38049096141969432, 87680418, 87680421, 3, 1366x768 
0x10EAE998, 38049096147291816, 87680950, 87680953, 3, 1366x768 
0x10EAE998, 38049096149287392, 87681127, 87681131, 4, 1366x768 
0x10EAE998, 38049096149956208, 87681196, 87681200, 4, 1366x768 
0x10EAE998, 38049096150624016, 87681267, 87681271, 4, 1366x768 
0x10EAE998, 38049096151292176, 87681332, 87681338, 6, 1366x768 
0x10EAE998, 38049096151960360, 87681399, 87681402, 3, 1366x768 
0x10EAE998, 38049096152630552, 87681486, 87681489, 3, 1366x768 
0x10EAE998, 38049096153298288, 87681531, 87681535, 4, 1366x768 
0x10EAE998, 38049096158621464, 87682085, 87682089, 4, 1366x768 
0x10EAE998, 38049096163964336, 87682619, 87682622, 3, 1366x768 
0x10EAE998, 38049096169298720, 87683153, 87683160, 7, 1366x768 
0x10EAE998, 38049096171305280, 87683330, 87683334, 4, 1366x768 
0x10EAE998, 38049096176671208, 87683869, 87683872, 3, 1366x768 
0x10EAE998, 38049096177345376, 87683937, 87683941, 4, 1366x768 
0x10EAE998, 38049096178013184, 87684002, 87684006, 4, 1366x768 
0x10EAE998, 38049096178675088, 87684071, 87684074, 3, 1366x768 
0x10EAE998, 38049096179340688, 87684134, 87684137, 3, 1366x768 
0x10EAE998, 38049096180009800, 87684225, 87684229, 4, 1366x768 
0x10EAE998, 38049096180677296, 87684288, 87684292, 4, 1366x768 
0x10EAE998, 38049096186013848, 87684822, 87684825, 3, 1366x768 
0x10EAE998, 38049096191373880, 87685357, 87685360, 3, 1366x768 
0x10EAE998, 38049096196058528, 87685805, 87685809, 4, 1366x768 
0x10EAE998, 38049096199388688, 87686159, 87686162, 3, 1366x768 
0x10EAE998, 38049096200057888, 87686211, 87686214, 3, 1366x768 
0x10EAE998, 38049096200743072, 87686274, 87686278, 4, 1366x768 
0x10EAE998, 38049096204076624, 87686610, 87686613, 3, 1366x768 
0x10EAE998, 38049096204739400, 87686677, 87686680, 3, 1366x768 
0x10EAE998, 38049096205414416, 87686743, 87686746, 3, 1366x768 
0x10EAE998, 38049096206084136, 87686811, 87686815, 4, 1366x768 
0x10EAE998, 38049096206757440, 87686876, 87686879, 3, 1366x768 
0x10EAE998, 38049096207430144, 87686944, 87686948, 4, 1366x768 
0x10EAE998, 38049096208100328, 87687011, 87687015, 4, 1366x768 
0x10EAE998, 38049096208773904, 87687077, 87687081, 4, 1366x768 
0x10EAE998, 38049096209432968, 87687143, 87687147, 4, 1366x768 
0x10EAE998, 38049096210108224, 87687211, 87687215, 4, 1366x768 
0x10EAE998, 38049096210776368, 87687279, 87687282, 3, 1366x768 
0x10EAE998, 38049096211446488, 87687347, 87687351, 4, 1366x768 
0x10EAE998, 38049096212111936, 87687409, 87687413, 4, 1366x768 
0x10EAE998, 38049096212785488, 87687482, 87687485, 3, 1366x768 
0x10EAE998, 38049096213450920, 87687547, 87687551, 4, 1366x768 
0x10EAE998, 38049096214118344, 87687618, 87687622, 4, 1366x768 
0x10EAE998, 38049096214787016, 87687682, 87687686, 4, 1366x768 
0x10EAE998, 38049096215454936, 87687743, 87687747, 4, 1366x768 
0x10EAE998, 38049096216123024, 87687813, 87687817, 4, 1366x768 
0x10EAE998, 38049096216791472, 87687881, 87687884, 3, 1366x768 
0x10EAE998, 38049096217462880, 87687944, 87687948, 4, 1366x768 
0x10EAE998, 38049096218134096, 87688013, 87688016, 3, 1366x768 
0x10EAE998, 38049096218804000, 87688081, 87688085, 4, 1366x768 
0x10EAE998, 38049096219475200, 87688149, 87688153, 4, 1366x768 
0x10EAE998, 38049096220134784, 87688217, 87688221, 4, 1366x768 
0x10EAE998, 38049096220803912, 87688280, 87688283, 3, 1366x768 
0x10EAE998, 38049096221474992, 87688347, 87688351, 4, 1366x768 
0x10EAE998, 38049096222150864, 87688416, 87688420, 4, 1366x768 
0x10EAE998, 38049096222812808, 87688483, 87688486, 3, 1366x768 
0x10EAE998, 38049096223484712, 87688553, 87688557, 4, 1366x768 
0x10EAE998, 38049096224159384, 87688617, 87688621, 4, 1366x768 
0x10EAE998, 38049096224831512, 87688705, 87688709, 4, 1366x768 
0x10EAE998, 38049096225497440, 87688762, 87688766, 4, 1366x768 
0x10EAE998, 38049096230834536, 87689305, 87689308, 3, 1366x768 
0x10EAE998, 38049096231502248, 87689351, 87689355, 4, 1366x768 
0x10EAE998, 38049096232172216, 87689421, 87689424, 3, 1366x768 
0x10EAE998, 38049096232844632, 87689484, 87689487, 3, 1366x768 
0x10EAE998, 38049096233513088, 87689554, 87689557, 3, 1366x768 
0x10EAE998, 38049096234181024, 87689617, 87689620, 3, 1366x768 
0x10EAE998, 38049096234848888, 87689688, 87689691, 3, 1366x768 
0x10EAE998, 38049096235515976, 87689752, 87689755, 3, 1366x768 
0x10EAE998, 38049096236184696, 87689821, 87689824, 3, 1366x768 
0x10EAE998, 38049096236856168, 87689888, 87689892, 4, 1366x768 
0x10EAE998, 38049096237522456, 87689954, 87689958, 4, 1366x768 
0x10EAE998, 38049096238187400, 87690023, 87690027, 4, 1366x768 
0x10EAE998, 38049096238855144, 87690085, 87690089, 4, 1366x768 
0x10EAE998, 38049096239523448, 87690153, 87690157, 4, 1366x768 
0x10EAE998, 38049096240195224, 87690218, 87690222, 4, 1366x768 
0x10EAE998, 38049096240863264, 87690287, 87690290, 3, 1366x768 
0x10EAE998, 38049096241533040, 87690354, 87690358, 4, 1366x768 
0x10EAE998, 38049096242202536, 87690424, 87690428, 4, 1366x768 
0x10EAE998, 38049096242861312, 87690487, 87690491, 4, 1366x768 
0x10EAE998, 38049096243535416, 87690557, 87690560, 3, 1366x768 
0x10EAE998, 38049096244203960, 87690621, 87690625, 4, 1366x768 
0x10EAE998, 38049096244887104, 87690710, 87690713, 3, 1366x768 
0x10EAE998, 38049096245552144, 87690757, 87690760, 3, 1366x768 
0x10EAE998, 38049096246220720, 87690823, 87690827, 4, 1366x768 
0x10EAE998, 38049096246884024, 87690888, 87690891, 3, 1366x768 
0x10EAE998, 38049096247545496, 87690960, 87690965, 5, 1366x768 
0x10EAE998, 38049096248220464, 87691026, 87691030, 4, 1366x768 
0x10EAE998, 38049096248878632, 87691092, 87691095, 3, 1366x768 
0x10EAE998, 38049096249536944, 87691158, 87691161, 3, 1366x768 
0x10EAE998, 38049096250206056, 87691223, 87691226, 3, 1366x768 
0x10EAE998, 38049096250880096, 87691290, 87691294, 4, 1366x768 
0x10EAE998, 38049096255554128, 87691757, 87691761, 4, 1366x768 
0x10EAE998, 38049096256218232, 87691826, 87691830, 4, 1366x768 
0x10EAE998, 38049096256889936, 87691889, 87691892, 3, 1366x768 
0x10EAE998, 38049096257554712, 87691958, 87691962, 4, 1366x768 
0x10EAE998, 38049096258224112, 87692021, 87692024, 3, 1366x768 
0x10EAE998, 38049096258898016, 87692089, 87692093, 4, 1366x768 
0x10EAE998, 38049096259561144, 87692159, 87692162, 3, 1366x768 
0x10EAE998, 38049096260231736, 87692228, 87692232, 4, 1366x768 
0x10EAE998, 38049096260898560, 87692293, 87692296, 3, 1366x768 
0x10EAE998, 38049096261567360, 87692357, 87692360, 3, 1366x768 
0x10EAE998, 38049096262233128, 87692425, 87692428, 3, 1366x768 
0x10EAE998, 38049096262906304, 87692491, 87692495, 4, 1366x768 
0x10EAE998, 38049096263579648, 87692558, 87692561, 3, 1366x768 
0x10EAE998, 38049096264248208, 87692629, 87692633, 4, 1366x768 
0x10EAE998, 38049096264927072, 87692692, 87692696, 4, 1366x768 
0x10EAE998, 38049096265595504, 87692760, 87692763, 3, 1366x768 
0x10EAE998, 38049096266265464, 87692827, 87692830, 3, 1366x768 
0x10EAE998, 38049096267606920, 87692977, 87692980, 3, 1366x768 
0x10EAE998, 38049096268279400, 87693028, 87693032, 4, 1366x768 
0x10EAE998, 38049096268942560, 87693094, 87693098, 4, 1366x768 
0x10EAE998, 38049096269614264, 87693160, 87693164, 4, 1366x768 
0x10EAE998, 38049096270281200, 87693227, 87693231, 4, 1366x768 
0x10EAE998, 38049096270954880, 87693298, 87693302, 4, 1366x768 
0x10EAE998, 38049096276312944, 87693831, 87693834, 3, 1366x768 
0x10EAE998, 38049096276981336, 87693902, 87693905, 3, 1366x768 
0x10EAE998, 38049096277649400, 87693968, 87693971, 3, 1366x768 
0x10EAE998, 38049096278319232, 87694035, 87694039, 4, 1366x768 
0x10EAE998, 38049096278991520, 87694101, 87694105, 4, 1366x768 
0x10EAE998, 38049096279659112, 87694169, 87694173, 4, 1366x768 
0x10EAE998, 38049096280325552, 87694236, 87694239, 3, 1366x768 
0x10EAE998, 38049096280994304, 87694299, 87694303, 4, 1366x768 
0x10EAE998, 38049096281657392, 87694372, 87694376, 4, 1366x768 
0x10EAE998, 38049096282325616, 87694433, 87694436, 3, 1366x768 
0x10EAE998, 38049096285003904, 87694702, 87694705, 3, 1366x768 
0x10EAE998, 38049096285672016, 87694768, 87694772, 4, 1366x768 
0x10EAE998, 38049096286346992, 87694838, 87694842, 4, 1366x768 
0x10EAE998, 38049096287021640, 87694903, 87694906, 3, 1366x768 
0x10EAE998, 38049096287694504, 87694972, 87694976, 4, 1366x768 
0x10EAE998, 38049096288361640, 87695046, 87695051, 5, 1366x768 
0x10EAE998, 38049096289034440, 87695104, 87695107, 3, 1366x768 
0x10EAE998, 38049096289713208, 87695173, 87695176, 3, 1366x768 
0x10EAE998, 38049096290374664, 87695238, 87695241, 3, 1366x768 
0x10EAE998, 38049096291044064, 87695310, 87695314, 4, 1366x768 
0x10EAE998, 38049096291729912, 87695377, 87695380, 3, 1366x768 
0x10EAE998, 38049096292390624, 87695443, 87695447, 4, 1366x768 
0x10EAE998, 38049096295066360, 87695710, 87695714, 4, 1366x768 
0x10EAE998, 38049096295734008, 87695774, 87695778, 4, 1366x768 
0x10EAE998, 38049096296406592, 87695853, 87695856, 3, 1366x768 
0x10EAE998, 38049096297075560, 87695911, 87695914, 3, 1366x768 
0x10EAE998, 38049096297749096, 87695975, 87695978, 3, 1366x768 
0x10EAE998, 38049096298419504, 87696045, 87696048, 3, 1366x768 
0x10EAE998, 38049096299091392, 87696113, 87696118, 5, 1366x768 
0x10EAE998, 38049096299754504, 87696178, 87696182, 4, 1366x768 
0x10EAE998, 38049096300420592, 87696244, 87696248, 4, 1366x768 
0x10EAE998, 38049096301093368, 87696310, 87696314, 4, 1366x768 
0x10EAE998, 38049096301760824, 87696376, 87696379, 3, 1366x768 
0x10EAE998, 38049096302430256, 87696445, 87696449, 4, 1366x768 
0x10EAE998, 38049096303097560, 87696509, 87696512, 3, 1366x768 
0x10EAE998, 38049096307110584, 87696913, 87696917, 4, 1366x768 
0x10EAE998, 38049096307774984, 87696977, 87696981, 4, 1366x768 
0x10EAE998, 38049096311781768, 87697381, 87697385, 4, 1366x768 
0x10EAE998, 38049096312454984, 87697448, 87697452, 4, 1366x768 
0x10EAE998, 38049096313123336, 87697517, 87697521, 4, 1366x768 
0x10EAE998, 38049096313797488, 87697579, 87697583, 4, 1366x768 
0x10EAE998, 38049096314468448, 87697647, 87697651, 4, 1366x768 
0x10EAE998, 38049096315134968, 87697715, 87697719, 4, 1366x768 
0x10EAE998, 38049096315801312, 87697784, 87697788, 4, 1366x768 
0x10EAE998, 38049096316470416, 87697846, 87697850, 4, 1366x768 
0x10EAE998, 38049096317143472, 87697914, 87697918, 4, 1366x768 
0x10EAE998, 38049096317817400, 87697984, 87697988, 4, 1366x768 
0x10EAE998, 38049096318485848, 87698049, 87698053, 4, 1366x768 
0x10EAE998, 38049096319149912, 87698117, 87698121, 4, 1366x768 
0x10EAE998, 38049096319821776, 87698181, 87698185, 4, 1366x768 
0x10EAE998, 38049096320486224, 87698253, 87698256, 3, 1366x768 
0x10EAE998, 38049096321147856, 87698315, 87698318, 3, 1366x768 
0x10EAE998, 38049096321816032, 87698386, 87698389, 3, 1366x768 
0x10EAE998, 38049096322485672, 87698468, 87698471, 3, 1366x768 
0x10EAE998, 38049096324482232, 87698654, 87698658, 4, 1366x768 
0x10EAE998, 38049096325147672, 87698716, 87698720, 4, 1366x768 
0x10EAE998, 38049096325814616, 87698783, 87698787, 4, 1366x768 
0x10EAE998, 38049096326483424, 87698870, 87698874, 4, 1366x768 
0x10EAE998, 38049096327820344, 87698983, 87698986, 3, 1366x768 
0x10EAE998, 38049096328483704, 87699049, 87699053, 4, 1366x768 
0x10EAE998, 38049096329159112, 87699119, 87699122, 3, 1366x768 
0x10EAE998, 38049096329821808, 87699204, 87699208, 4, 1366x768 
0x10EAE998, 38049096331152920, 87699318, 87699322, 4, 1366x768 
0x10EAE998, 38049096331813528, 87699388, 87699392, 4, 1366x768 
0x10EAE998, 38049096332484192, 87699451, 87699455, 4, 1366x768 
0x10EAE998, 38049096333155992, 87699518, 87699522, 4, 1366x768 
0x10EAE998, 38049096333824680, 87699585, 87699589, 4, 1366x768 
0x10EAE998, 38049096334485144, 87699652, 87699655, 3, 1366x768 
0x10EAE998, 38049096335155488, 87699720, 87699724, 4, 1366x768 
0x10EAE998, 38049096335829056, 87699782, 87699786, 4, 1366x768 
0x10EAE998, 38049096336502696, 87699856, 87699860, 4, 1366x768 
0x10EAE998, 38049096337166896, 87699930, 87699937, 7, 1366x768 
0x10EAE998, 38049096337836512, 87699988, 87699991, 3, 1366x768 
0x10EAE998, 38049096338504184, 87700053, 87700057, 4, 1366x768 
0x10EAE998, 38049096339172624, 87700120, 87700123, 3, 1366x768 
0x10EAE998, 38049096339842968, 87700187, 87700190, 3, 1366x768 
0x10EAE998, 38049096340517256, 87700255, 87700258, 3, 1366x768 
0x10EAE998, 38049096341186560, 87700320, 87700323, 3, 1366x768 
0x10EAE998, 38049096341857088, 87700388, 87700391, 3, 1366x768 
0x10EAE998, 38049096342536872, 87700457, 87700461, 4, 1366x768 
0x10EAE998, 38049096343202904, 87700520, 87700524, 4, 1366x768 
0x10EAE998, 38049096343871616, 87700587, 87700590, 3, 1366x768 
0x10EAE998, 38049096344540688, 87700654, 87700659, 5, 1366x768 
0x10EAE998, 38049096345206136, 87700723, 87700727, 4, 1366x768 
0x10EAE998, 38049096345873680, 87700791, 87700794, 3, 1366x768 
0x10EAE998, 38049096346546008, 87700874, 87700878, 4, 1366x768 
0x10EAE998, 38049096347882576, 87700988, 87700992, 4, 1366x768 
0x10EAE998, 38049096349883096, 87701190, 87701194, 4, 1366x768 
0x10EAE998, 38049096350551704, 87701260, 87701269, 9, 1366x768 
0x10EAE998, 38049096351219776, 87701332, 87701336, 4, 1366x768 
0x10EAE998, 38049096351892744, 87701389, 87701393, 4, 1366x768 
0x10EAE998, 38049096352562176, 87701456, 87701460, 4, 1366x768 
0x10EAE998, 38049096353238096, 87701546, 87701551, 5, 1366x768 
0x10EAE998, 38049096353907176, 87701592, 87701597, 5, 1366x768 
0x10EAE998, 38049096354575384, 87701663, 87701667, 4, 1366x768 
0x10EAE998, 38049096355241048, 87701725, 87701729, 4, 1366x768 
0x10EAE998, 38049096355906448, 87701792, 87701796, 4, 1366x768 
0x10EAE998, 38049096356580096, 87701881, 87701885, 4, 1366x768 
0x10EAE998, 38049096357248512, 87701928, 87701931, 3, 1366x768 
0x10EAE998, 38049096357915864, 87701996, 87701999, 3, 1366x768 
0x10EAE998, 38049096358582864, 87702063, 87702067, 4, 1366x768 
0x10EAE998, 38049096359253576, 87702127, 87702130, 3, 1366x768 
0x10EAE998, 38049096359926080, 87702196, 87702199, 3, 1366x768 
0x10EAE998, 38049096360593328, 87702264, 87702268, 4, 1366x768 
0x10EAE998, 38049096361267352, 87702328, 87702331, 3, 1366x768 
0x10EAE998, 38049096361939352, 87702397, 87702401, 4, 1366x768 
0x10EAE998, 38049096362597768, 87702465, 87702469, 4, 1366x768 
0x10EAE998, 38049096363264000, 87702526, 87702530, 4, 1366x768 
0x10EAE998, 38049096363928320, 87702594, 87702598, 4, 1366x768 
0x10EAE998, 38049096364597112, 87702665, 87702669, 4, 1366x768 
0x10EAE998, 38049096365261816, 87702730, 87702734, 4, 1366x768 
0x10EAE998, 38049096365934696, 87702795, 87702799, 4, 1366x768 
0x10EAE998, 38049096366600672, 87702866, 87702870, 4, 1366x768 
0x10EAE998, 38049096367262536, 87702927, 87702930, 3, 1366x768 
0x10EAE998, 38049096367933792, 87702993, 87702997, 4, 1366x768 
0x10EAE998, 38049096368600928, 87703060, 87703064, 4, 1366x768 
0x10EAE998, 38049096369267880, 87703131, 87703135, 4, 1366x768 
0x10EAE998, 38049096369938496, 87703195, 87703199, 4, 1366x768 
0x10EAE998, 38049096370606000, 87703263, 87703266, 3, 1366x768 
0x10EAE998, 38049096371276400, 87703343, 87703346, 3, 1366x768 
0x10EAE998, 38049096371939880, 87703393, 87703397, 4, 1366x768 
0x10EAE998, 38049096372615816, 87703468, 87703472, 4, 1366x768 
0x10EAE998, 38049096373282640, 87703530, 87703534, 4, 1366x768 
0x10EAE998, 38049096373948192, 87703595, 87703598, 3, 1366x768 
0x10EAE998, 38049096376684848, 87703892, 87703946, 54, 1366x768 
